,English Sentences,Hindi Sentences,Word Count (English),Word Count (Hindi),Difference between Word Count (English) and Word Count (Hindi)
13,"Meanwhile, three people came there on a bike. ",इसी बीच एक बाइक पर तीन लोग आते दिखाई दिए। ,46,42,4
18,Share videos ,वीडियो क्लिप शेयर किए ,13,22,-9
23,"""They are not seen anywhere. ",दोनों ही कहीं भी दिखाई नहीं पड़ रहे। ,29,36,-7
27,Both are safe and healthy. ,सभी सुरक्षित और खतरे से बाहर हैं। ,27,34,-7
34,Im fine by the grace of God. ,ईश्वर की कृपा से मैं बिल्कुल ठीक हूं. ,29,38,-9
35,But its still a long way to go. ,लेकिन वापस जाने को अभी लंबा अंतराल है। ,32,39,-7
36,Hockey: India to face Belgium in test series ,हॉकी टेस्ट : भारत ने अर्जेटीना को बराबरी पर रोका ,45,49,-4
38,"""The FIR Exhibit Ka-19 ",एफआईआर प्रदर्शनी के -19 ,23,24,-1
40,This caused panic among consumers. ,इस कारण उपभोक्ताओं के बीच हंगामा मच गया था। ,35,44,-9
55,"""The bench rejected the petition. ",एकलपीठ ने याचिका खारिज कर दी। ,34,30,4
58,I had never been away from the game for so long. ,मैं कभी इतने लंबे समय तक खेल से दूर नहीं रहा। ,49,46,3
59,I must go. ,मुझे जाना चाहिए. ,11,17,-6
61,Artists are the moral conscience of society. ,कलाकार किसी समाज का नैतिक विवेक होते हैं. ,45,42,3
62,People are sad and angry. ,इससे लोग दुखी व हताश है। ,26,25,1
63,Lets look at some statistics. ,"आइए, कुछ आंकड़े देखते हैं। ",30,26,4
69,"In fact, India with... ","दरअसल, भारतीय . पढ़ें ",23,22,1
75,MeToo in India the ugliness has shaken me up. ,Metoo आंदोलन भारत में सनसनी की तरह फैल रहा है। ,46,47,-1
77,Everything for Germany. ,जर्मनी के लिए सब कुछ.. ,24,23,1
79,Why do they do that? she asked. ,उन्होंने पूछा कि ऐसा क्यों कर रहे हैं। ,32,39,-7
81,"However, he didnt rule out the possibility. ",हालांकि उन्होंने संभावनाओं को खारिज भी नहीं किया। ,44,50,-6
83,Three persons were arrested by the police. ,जबकि तीन को पुलिस टीम ने गिरफ्तार कर लिया। ,43,43,0
86,who use our product are not necessarily ,जो हमारे उत्पाद का इस्तेमाल जरूरी नहीं हैं ,40,43,-3
90,We have seen good growth. ,हमें अच्छी वृद्धि नजर आ रही है। ,26,32,-6
95,"""They've stopped. ",वे रुक गये है. ,18,15,3
99,"""The accused is cousin brother of the victim. ",आरोपी रिश्ते में पीड़िता का चचेरा भाई है। ,46,42,4
101,But they never got going. ,हालांकि वे कभी गए नहीं। ,26,24,2
106,"UK to accept 20,000 refugees from Syria ","15,000 सीरियाई लोगों को शरण देगा ब्रिटेन ",40,41,-1
109,"""""""There is no case of coronavirus so far."" ",अभी तो यहां कोरोना वायरस का कोई केस नहीं आया है। ,44,49,-5
110,Most of these are of clay. ,इनमें ज्यादातर पाकुड़ के हैं। ,27,30,-3
112,All of them were from Uttar Pradesh. ,यह सभी लोग उत्तरप्रदेश के लोग थे। ,37,34,3
130,No action has been taken in this regard. ,इस पर कार्यकर्ताओं पर कोई कार्रवाई नहीं की गई है। ,41,50,-9
136,A family case is going on in the court currently. ,तलाक का मामला फिलहाल फैमिली कोर्ट में चल रहा है। ,50,49,1
141,This makes the skin soft and supple. ,"इससे स्किन सॉफ्ट, ग्लोइंग बनती है। ",37,35,2
147,Its a religion over there. ,धार्मिक वहीं है। ,27,17,10
154,No one can create an atmosphere. ,कोई व्यक्ति कोई माहौल नहीं बना सकता. ,33,37,-4
155,This will change the scenario. ,यह परिदृश्य बदलने वाला होगा। ,31,29,2
156,"Later, a compromise had been worked out. ",बाद में सुलह समझौता भी हो गया था। ,41,34,7
158,Zero is an even number. ,शून्य एक सम संख्या है। ,24,23,1
182,Message From Abroad ,विदेशों से भी आ रहे खत ,20,23,-3
183,walk this way ,चलते हैं यहां ,14,14,0
185,"""The film is in production stages currently. ",फिल्म फिलहाल निर्माण के अंतिम चरण में है। ,45,42,3
200,So why is this controversial? ,तो फिर इतना विवाद क्यों ,30,24,6
206,"Since then,the accused had been harassing her. ",उसके बाद से आरोपी उससे रंजिश रखने लगे। ,47,39,8
218,Protesters had blocked the road. ,प्रदर्शनकारियों ने सड़क को जाम कर रखा था। ,33,42,-9
220,She lived alone in the house. ,मकान में वह अकेला रहता था। ,30,27,3
232,Many have been killed. ,बहुत से लोग मारे गए” ,23,21,2
245,Important instructions for candidates ,उम्मीदवारों के लिए जरूरी निर्देश ,38,33,5
260,"""They are now in search of a new servant. ",वे अब एक नए नौकर की तलाश में हैं। ,42,34,8
264,Our government works for the poor. ,हमारी सरकार गरीबों के लिए काम कर रही है। ,35,41,-6
266,"However, we parted on good terms. 23. ",फिर भी हम मित्रों की तरह एक-दूसरे से विदा हुए। ,38,47,-9
270,off the road ,सड़क पर बाहरी ,13,14,-1
272,Her death is being linked to Sushants death. ,उनकी मौत को सुशांत की मौत से जोड़ा जा रहा है। ,45,46,-1
297,as a mark of ,के प्रति ,13,9,4
304,Where the case began ,कहां से शुरू हुआ मामला ,21,23,-2
309,This trend is here to stay. ,यह ट्रेंड आगे भी बना रह सकता है। ,28,33,-5
313,"""They are our role models. ",वे हमारे आदर्श हैं। ,27,20,7
315,Three policemen were injured in this incident. ,इस घटना में तीन पुलिस वाले घायल हुए हैं। ,47,41,6
316,India love to hate Pakistan. ,"पाकिस्तान, जितनी घृणा भारत से करता है। ",29,39,-10
321,She beats him. ,"""वह उसे मार दिया. ",15,18,-3
338,"""The film was much enjoyed by the audience. ",फिल्म को दर्शकों ने बहुत पंसद किया था. ,44,39,5
339,brisk trading ,अधिक लेनदेन ,14,12,2
340,Expenditure incurred (Amount in Rs.) ,किया गया खर्च (राशि रुपये में) ,37,31,6
342,"""The answer is BJP. ",बीजेपी ने इसका जवाब दिया है. ,20,29,-9
343,Whos responsible for this? ,सर इसके लिए कौन जिम्मेदार हैं? ,27,31,-4
346,Its objectives are to: - ,इसके उद्देश्य हैः ,25,18,7
348,"""There is law in the country. ",देश में कानून का शासन है। ,30,26,4
350,Mountains are covered with ice. ,पहाड़ बर्फ से लकदक हो गए हैं. ,32,30,2
352,That's my answer to the overpopulation question. ,अधिक जनसंख्या के सवाल का यह मेरा ज़वाब है. ,49,42,7
362,"""Then, heat oil in a pan. ",इसके बाद कड़ाही में घी डालें। ,26,30,-4
365,"""The final decision will be taken by the Court. ",उच्च अदालत का फैसला अंतिम माना जाएगा। ,48,38,10
370,"""Theres nothing bad in it. ",इस में कुछ बुरा भी नहीं है। ,27,28,-1
379,We're pulling clear of them. ,उनमें से cIear खींच रहे हैं. ,29,29,0
380,Aman Sharma awarded ,एके शर्मा ने सम्मानित किया। ,20,28,-8
383,Officers will be pleased with your work. ,अधिकारी आप के काम से प्रसन्न होंगे। ,41,36,5
389,"Mandi Ahmedgarh, October 7 ","महेन्द्रगढ़, 7 अक्तूबर (निस) ",27,29,-2
390,"""Theres no dispute about that. ",इसमें किसी तरह का विवाद नहीं है। ,31,33,-2
394,Avoid an argument with your spouse. ,जीवनसाथी से झगड़ा करने से बचें। ,36,32,4
400,You need to wait for the right time. ,सही समय का इंतजार जरूरी है। ,37,28,9
402,He was arrested on Thursday. ,गुरुवार को इस पर मुहर लगाई गई। ,29,31,-2
403,"So Im really, really happy for them. ",इसलिए मैं उनसे बहुत खुश हूं। ,37,29,8
421,Im super-excited about the release of the film. ,इस फिल्म की रिलीज के लिए बहुत रोमांचित हूं। ,48,44,4
422,He was produced in court. ,उसे कोर्ट में पेश कर दिया गया। ,26,31,-5
424,(The writer is a Political Analyst) ,(लेखक नेपाल के राजनीतिक विश्लेषक हैं) ,36,38,-2
431,"""They identified him. ",इन्हीं से उनकी शिनाख्त हुई। ,22,28,-6
436,I am going with them. ,ैं उनके साथ होती हूं। ,22,22,0
437,But nothing much changed. ,बदलता कुछ भी नहीं। ,26,19,7
438,Inequality is increasing rapidly. ,इससे असमानता तेजी से बढ़ रही है। ,34,33,1
440,What did you think about it? ,इस पर क्या सोचा है? ,29,20,9
452,Do try ,प्रयास करें ,7,12,-5
458,Why Albert Pinto is still angry? ,अल्बर्ट पिंटो को गुस्सा क्यों आता है ,33,37,-4
461,Thieves decamp with Rs 1.5 lakh ,युवक से 1.5 लाख की लूट ,32,23,9
480,"I saw everything, I heard everything. ","मैं सब कुछ देख रहा हूं, सब कुछ समझ रहा हूं। ",38,44,-6
481,You see the complete hopelessness in the eyes . ,खाली आँखों में सिमटकर नमदे की तरह हो जाते हैं। ,48,47,1
483,"When he objected, they started beating him up. ",विरोध किया तो उसकी पिटाई शुरू कर दी। ,47,37,10
492,He is a resident of Delhis Shahdara. ,ये दिल्ली के शाहदरा निवासी हैं। ,37,32,5
494,Devotees take dip in Brahma Sarovar ,श्रद्धालुओं ने ब्रह्मसरोवर में लगाई डुबकी ,36,42,-6
504,OnePlus 6T India launch will begin soon. ,वनप्लस 6 टी को जल्द ही लॉन्च किया जा सकता है। ,41,46,-5
512,He died due to heart attack. ,दिल का दौरा पड़ने से मौत हुई है. ,29,32,-3
513,Where to go on this weekend? ,इस Weekend पर कहां जाऊं? ,29,25,4
528,Reliance Power exits Tiaiya power project ,रिलायंस पावर को मिली तिलैया परियोजना ,42,37,5
531,What officers say ,क्या कहते हैं कंपनी अधिकारी ,18,28,-10
544,None of us had been in a situation like this. ,उनकी किसी से कोई इस तरह की बात ही नहीं हुई थी। ,46,47,-1
546,Special situation of Jammu and Kashmir ,जम्मू कश्मीर की विशेष स्थिति ,39,29,10
549,Pour in a bit of water and bring it to a boil. ,थोड़ा-थोड़ा पानी डालकर उसे गूंथ लें। ,47,37,10
551,Chief Minister Yogi Adityanath ,साथ में मुख्यमंत्री योगी आदित्यनाथ ,31,35,-4
552,British English (en-gb) ,ब्रिटिश अंग्रेज़ी (en- gb) ,24,27,-3
555,We need results. ,हमें रिजल्ट चाहिए। ,17,19,-2
557,Memory Trainers Only ,केवल स्मृति प्रशिक्षकों ,21,24,-3
562,1857 The Uprising ,1857 द अपराइजिंग ,18,17,1
566,"""The specified folder may not be empty. ",उल्लेखित फ़ोल्डर शायद खाली नहीं है. ,40,36,4
571,Recovery of Dues by DC ,डीसी द्वारा बकाये की वसूली ,23,27,-4
574,stool is a solid end product of digested food. ,मल पाचन किए गए भोजन का ठोस अंतिम उत्पाद होता है. ,47,49,-2
582,"""""""It's a challenge for everybody."" ","उन्होंने कहा, ‘यह हर किसी के लिए चुनौती है। ",36,44,-8
583,Time limit for application for sale ,तीन. विक्रय के लिए आवेदन के लिए समय सीमा ,36,41,-5
585,And every story I have is like 50 years later. ,और हर कहानी ई अब यह लीक 4 साल का पत्र है। ,47,42,5
586,Fire destroys crop in 6 villages ,6 गांवों की सैकड़ों एकड़ भूमि में लगी आग ,33,41,-8
591,This film is not fictitious. ,' यह मूवी 100 फीसदी वीएफएक्सह है। ,29,34,-5
595,Batas iconic tennis shoes. ,बाटा का आइकॉनिक टेनिस जूता ,27,27,0
597,"""The courts judgment has to be respected. ",कोर्ट का यह फैसला स्वागतयोग्य है। ,42,34,8
600,"Subsequently, the matter reached high court. ",बाद में मामला उच्च प्रबंधन तक पहुंचा। ,45,38,7
601,"""The most powerful and effective. ",सर्वाधिक शक्तिशाली और प्रभावी। ,34,31,3
602,New laws are necessary. ,नये कानून बनेंगे. ,24,18,6
616,Neogen Chem 26 April 2019 41 215 358 ,Neogen Chem 26 अप्रैल 2019 41 215 358 66. ,37,42,-5
620,"""The culprit has been arrested, ",‘जाल डालकर पकड़ा गया आरोपी’ ,32,28,4
626,"""They have to be evacuated. ",उन्हें हटाना पड़ेगा. ,28,21,7
629,Opportunities @ RBI ,भारतीय रिज़र्व बैंक में करियर ,20,30,-10
634,"Explanation.For the purposes of this clause, ",स्पष्टीकरण.–इस खंड के प्रयोजनों के लिए– ,45,40,5
641,This will lock your computer system. ,इससे आपका कम्प्यूटर सिस्टम लॉक हो जाएगा। ,37,41,-4
645,Focus on Previous Message ,पिछले संदेश पर फ़ोकस करें ,26,26,0
654,Move to the last sheet ,अंतिम शीट में जाएं ,23,19,4
655,Tata Patna High Court ,टाटा पटना उच्च न्यायालय ,22,24,-2
656,Why was it needed? ,इसकी •ारूरत क्यों पड़ी? ,19,24,-5
663,Finch's goal is to continue till 2023 World Cup ,2023 विश्व कप तक खेलना चाहते हैं फिंच ,48,38,10
672,Pravin Dubey (Base price Rs 20 lakhs) ,"प्रवीण दुबे, 20 लाख बेस प्राइस नहीं बिके फिर ",38,45,-7
673,He is under constant observation. ,"""वह लगातार औचक निरीक्षण में जुटे हैं. ",34,38,-4
674,"""The Moon is the Moon! ",चांद कसूरवार है! ,23,17,6
675,"But, she did not respond. ",मगर उन्होंने कोई जवाब नहीं दिया। ,26,33,-7
681,This isnt looking good. ,ये अच्छा नहीं लग रहा है. ,24,25,-1
682,"""The rivalry between the two teams was intense. ",दोनों टीमों के बीच मुकाबला बेहद रोमांचक रहा। ,48,45,3
686,Always show this window ,इस विंडो को हमेशा दिखाएँ (w) ,24,29,-5
687,"""There is no compulsion. ",इसमें कोई मजबूरी नहीं है। ,25,26,-1
689,A cage was placed to catch the leopard. ,बाघ को पकडऩे के लिए पिंजरा लगा दिया गया है। ,40,44,-4
692,This happens all over the world. ,पूरी दुनिया में ऐसा होता है. ,33,29,4
693,This government cannot be trusted. ,उस पर सरकार को भरोसा नहीं। ,35,27,8
699,utmost(a) ,जीतोड़ ,10,7,3
703,It's has happened before ,इससे पहले यह हो चुका है ,25,24,1
708,She is Japanese. ,"""वह जापानी है। ",17,15,2
710,Its only the feel. ,इसका केवल आभास होता है। ,19,24,-5
713,He made 500 runs in the tournament. ,उन्होंने अपने जीवन में 500 पारियां खेलीं. ,36,42,-6
723,Here a look at who said what: ,आइये जानें किसने क्या कहा: ,30,27,3
751,"""They havetested negative in the first test. ",पहली परीक्षण में वे निगेटिव पाए गए हैं। ,45,40,5
754,Xi-Modi meeting ,मोदी-जेसिंड मीटिंग ,16,19,-3
761,Officials of various departments were present. ,जनसुनवाई में विभिन्न विभागीय अधिकारी उपस्थित रहे। ,47,50,-3
770,Central Library ,सेंट्रल लाइब्रेरी ,16,18,-2
775,This is important for the country. ,राष्ट्र के लिए ये महत्वपूर्ण है. ,35,33,2
778,"Now, it's not perfect. ","अब, यह सही नहीं है. ",23,20,3
788,Connectivity features ,कनेक्टेड फीचर्स ,22,16,6
789,We have to be on guard. ,हमें अपनी तैयार रखनी है। ,24,25,-1
790,It's not illegal. ,यह गैरकानूनी भी नहीं है। ,18,25,-7
791,Police Constable (Civil ,पुलिस कांस्टेबल (सिविल ,24,23,1
793,"And taking this Latin thing, this hymn thing. ",'अन्टू द लास्ट' का अर्थ है - इस अंतवाले को भी। ,46,47,-1
801,y 's that are below the first line. ,y 's कि पहली रेखा से नीचे हैं। ,36,31,5
810,He explained why. ,उन्होंने इसकी वजह भी बताई। ,18,27,-9
820,Shalu-Kalu a funny boy girl pair. ,शालू-कालू – एक मजेदार लड़के-लड़की की जोड़ी। ,34,44,-10
822,This is based on a true story. ,यह एक रियल स्टोरी पर बेस्ड है। ,31,31,0
824,I 'm coming with you. ,मैं तुम्हारे साथ आ रहा हूँ. ,22,28,-6
825,It is helmed by Ali Abbas Zafar. ,इसे अली अब्बास जफर डायरेक्ट कर रहे हैँ। ,33,40,-7
829,Channel Owners (+ q) ,चैनल मालिक ,21,11,10
831,"""The accused fled from the spot after the crime. ",हत्या के बाद आरोपी मौके से फरार हो गया. ,49,40,9
833,"""The Burning Train ",द बर्निंग ट्रेन ,19,16,3
834,Select it. ,इसके सिलेक्ट कर लें। ,11,21,-10
837,"""The Indian army too gave a befitting response. ",जिसका भारतीय सेना ने भी मुंहतोड़ जवाब दिया। ,48,44,4
838,"Joint Secretary (Films), Ministry of I&B ","संयुक्‍त सचिव (फिल्म), सूचना एवं प्रसारण मंत्रालय ",41,50,-9
839,"However, the truth came to the fore later. ",पर थोड़ी ही देर बाद सच्चाई सामने आ गई. ,43,39,4
842,Same holds true in cricket. ,क्रिकेट भी ऐसा ही है. ,28,22,6
843,Not to love. ,लव मैरिज नहीं। ,13,15,-2
848,"""Theyre not bodies. ",ये जीवत नहीं होते हैं। ,20,23,-3
855,This really has happened. ,ऐसा सचमुच हुआ है. ,26,18,8
863,Will you punish him? ,आपलोग सजा देंगे न? ,21,19,2
864,"""The great tragedienne Rachel lived in No. 9. ",महान त्रसदीकार रेशेल 8 नंबर में रहती थीं। ,46,42,4
865,Six accused are absconding. ,छह आरोपित हुए थे फरार ,28,22,6
869,This is their life. ,इनसे ही उनका जीवन चलता है. ,20,27,-7
878,What choice did they have? ,उन्होंने अपने लिए क्या चुना है? ,27,32,-5
885,"Since then, the work is being done. ",तभी से इसे लेकर काम चल रहा है। ,36,31,5
891,"""The driver of the bus also died in the accident. ",इस हादसे में बस चालक की भी मौत हो गई है. ,50,41,9
893,He demanded an inquiry into the case. ,उन्होंने इस मामले में जांच की मांग की। ,38,39,-1
903,Chief Minister Uddhav Thackeray ,मुख्यमंत्री उद्धव ठाकरे भी रहेंगे उपस्थित ,32,42,-10
912,saddle horse ,राइडिंग हार्स ,13,14,-1
913,Everyone has to do their own thing. ,सबको अपने अपने हिस्से का काम करना होगा. ,36,40,-4
916,Whats happening in the trial? ,महाभियोग जांचमें क्या हो रहा है? ,30,33,-3
917,Fear spread in the village. ,इससे गांव में दहशत फैल गयी। ,28,28,0
922,Triple talaq should be banned. ,ट्रिपल तलाक बंद होना चाहिए। ,31,28,3
930,"No, its true. ","नहीं न, लेकिन ये सच . ",14,22,-8
934,NRC to be introduced throughout country: Shah ,जल्द ही पूरे देश में लागू होगी एनआरसी : शाह ,46,44,2
936,Come to me. ,तुम मेरे पास आओ। ,12,17,-5
942,He has also worked as a lawyer. ,उन्होंने वकील के रूप में भी काम किया. ,32,38,-6
947,He said ,उन्होंने कहा- ,8,14,-6
948,"""The status is as follows: ",स्थिति जस की तस: ,27,17,10
951,He said that this... ,उन्होंने कहा कि इस . ,21,21,0
963,That's brotherly love. ,ये भाई-बहन का प्यार है। ,23,24,-1
969,Yet no one said anything. ,तब भी कोई नहीं बोला। ,26,21,5
980,"""Thereafter the action was taken. ",इसके बाद यह कार्रवाई हुई है। ,34,29,5
985,But everyone has a right to give. ,लेकिन रूठने का हक सबको है। ,34,27,7
988,Feeling of weakness and tiredness ,कमजोरी और थकान महसूस होना ,34,26,8
989,"After all, why not? ",आखिर हो भी क्यों न। ,20,20,0
996,"In such cases, we need to be cautious. ",ऐसे में जरूरत सावधानी बरतने की है। ,39,35,4
997,Happy Birthday Sachin Tendulkar! ,सचिन को मिल रही जन्मदिन की बधाई ,33,32,1
1000,"US Secretary of State, Mike Pompeo ","माइक पोंपियो , अमेरिकी विदेश मंत्री&nbsp ",35,41,-6
1003,"""The former CM said: ",जिनमें पूर्व मुख्यमंत्री चौ. ,21,29,-8
1006,Exchange with register ,रजिस्टर के साथ विनिमय ,23,22,1
1009,FBI to assist in probe ,जांच में लगी एफबीआई ,23,20,3
1010,Barley is also low in fat. ,काजू में फैट भी कम होता है. ,27,28,-1
1014,Modis election bugle ,मोदी फूं केंगे चुनावी रणभेरी ,21,29,-8
1019,"""They want to divide India. ",वे चाहते हैं कि भारत का बंटवारा हो. ,28,36,-8
1025,because I was not a trade unionist. ,क्योंकि मैं एक ट्रेड यूनियनिस्ट नहीं था। ,36,41,-5
1027,He was against the partition of India. ,"""वह भारत विभाजन के विरुद्ध थे। ",39,31,8
1041,composite culture ,सामासिक संस्कृति ,18,17,1
1042,Dot - character printer ,बिंदु संप्रतीक प्रिंटर ,24,23,1
1047,We believe in partnerships. ,हम पारस्परिकता में विश्वास करते हैं। ,28,37,-9
1053,It sparked worldwide reactions. ,दुनिया भर में उसकी प्रतिक्रिया हुई. ,32,36,-4
1061,"So, this was where we left with. ","तो, हमारे पास है जहाँ . ",33,24,9
1069,"After that, rinse off with water. ",इसके बाद पानी से इसे धो दें। ,34,29,5
1070,She did not understand how this could come about. ,उनको समझ ही नहीं आखिर ऐसा कैसे हो सकता है. ,50,43,7
1077,"""Then add almonds in it. ",फिर इसमें हींग डालें। ,25,22,3
1080,EAC-PM has welcomed these comprehensive measures ,ईएसी-पीएम ने इन व्यापक कदमों का स्वागत किया है ,49,47,2
1083,Director: Inder Kumar ,निर्देशक: आनंद कुमार ,22,21,1
1090,I 'm going to meet him tomorrow. ,मैं कल उससे मिलने जा रहा हूँ। ,33,30,3
1101,"""The hospital lacks surgeon. ",अस्पताल में सर्जन की कमी है। ,29,29,0
1102,For us that is paramount. ,हमारे लिए ये सर्वोपरि है. ,26,26,0
1103,Dont go away! ,इससे दूर मत जाइए! ,14,18,-4
1104,Two youths killed in accidents ,दुर्घटना में दो युवकों की मौत ,31,30,1
1105,Concerns and solutions ,जिज्ञासा और समाधान ,23,19,4
1115,( c) New Zealand: ,( ख) आस्ट्रेलिया: ,18,18,0
1120,"Heavy rains lash Himachal, all rivers in spate ","हिमाचल में भारी बारिश, नदियां उफान पर ",47,38,9
1123,"New Tehri, May 15 ","चरखी दादरी, 15 मई ",18,18,0
1128,Social media will be strictly monitored. ,सोशल मीडिया पर रखी जाएगी पैनी नजर ,41,34,7
1129,Apply this paste over your face and neck. ,इस पेस्ट को चेहरे और गले पर लगा कर छोड़ दें। ,42,45,-3
1131,I have all the records and documents with me. ,मैं अपने साथ सभी दस्तावेज भी ले आऊंगा। ,46,39,7
1140,Khaleel has played 11 ODIs and 14 T20Is. ,खलील ने 11 वनडे और 14 टी20 मैच खेले हैं. ,41,41,0
1143,Don't talk to me. ,मुझसे बात मत करो! ,18,18,0
1150,92 new cases reported in Maharashtra ,महाराष्ट्र में 92 और मामले आए सामने ,37,36,1
1154,All's well that end's well. ,अंत भला तो सब भला. ,28,19,9
1162,He also gave his word on it. ,इसके लिए उन्होंने उपसूचना भी दी। ,29,33,-4
1168,Police said arrests will be made soon. ,पुलिस का दावा है कि शीघ्र ही वह गिरफ्त में होगा। ,39,49,-10
1170,"So, that is how it is oriented actually. ","तो, यह है कि यह वास्तव में कैसे उन्मुख है। ",41,43,-2
1171,PM Modi to visit Varanasi on Dev Deepawali ,देव दीपावली पर वाराणसी जा सकते हैं पीएम मोदी ,43,45,-2
1175,"""The company held an auction on his account. ",कंपनी ने उसके लेखे नीलामी का आयोजन किया। ,45,41,4
1186,Pricing of material ,सामग्री की कीमत निर्धारण ,20,25,-5
1187,He was very much loving me. ,वो मुझे सबसे ज्यादा प्यार करते थे। ,28,35,-7
1189,Rahul Gandhi at the Somnath Temple in Gujarat ,गुजरात के सोमनाथ मंदिर में राहुल गांधी ,46,39,7
1201,"""The youth died on the spot. ",घटना में युवक की मौके पर ही मौत हो गई। ,29,39,-10
1202,run-in ,झगड़ा ,7,6,1
1206,"""The alliance was only hurting it. ",गठबंधन बस इसे नुकसान पहुंचा रहा था। ,35,36,-1
1212,Step 5: The result will appear on your screen. ,चरण 5: अपना एमएड रिजल्ट आपकी स्क्रीन पर आ जाएगा। ,47,49,-2
1220,Suicide blast kills nine in Somalia ,सोमालिया में विस्फोट नौ लोगों की मौत ,36,37,-1
1222,"Winning the first match, was a good start. ",हमें पहला मैच जीतकर जो शुरुआत मिली वो अच्छी है। ,43,48,-5
1226,"Dhiraj Relli, MD & CEO, HDFC Securities ","धीरज रेल्ली, एमडी-सीईओ, एचडीएफसी सिक्योरिटीज ",40,45,-5
1230,"""There have been many reasons for this. ",कई कारण जिम्मेदार रहे इसके लिए। ,40,32,8
1231,Yet nothing was done. ,लेकिन कोई कार्यवाही नहीं हुई। ,22,30,-8
1233,Student Dies at School in Hyderabad ,हैदराबाद में इंटर छात्रा की निर्मम हत्या ,36,41,-5
1236,"Robbers target petrol pump again, decamp with ",कार सवार लुटेरों ने पेट्रोल पम्प लूटा ,46,38,8
1240,"""The police has found no evidence against him. ",पुलिस को उसके पास से कोई दस्तावेज नहीं मिले है। ,47,48,-1
1249,I worked hard. ,मैंने कड़ी मेहनत की। ,15,21,-6
1250,Students queries were taken up by experts. ,स्टूडेंट्स के सवालों के एक्सप‌र्ट्स ने जबाब दिए। ,43,49,-6
1251,RSV does cause epithelium damage. ,RSV से ऐपीथैलियम को नुकसान पहुंचता है। ,34,39,-5
1253,Check out this video- ,यह देखें वीडियो- ,22,17,5
1255,"So, cost is an important factor. ","तो, लागत एक महत्वपूर्ण कारक है। ",33,32,1
1257,You will get full support from your child. ,आपको संतान से पूरा सहयोग मिलेगा। ,43,33,10
1260,Election politics ,चुनावों की राजनीति ,18,19,-1
1264,"""They are very tough. ",वे बहुत ही मजबूर हैं. ,22,22,0
1265,Abhishek's father is a retired IPS officer. ,अभिषेक के पिता वेटेरनरी फील्ड ऑफिसर हैं। ,44,41,3
1274,bird of night ,वायसांतक ,14,9,5
1276,"""The Opposition needs a direction. ",विपक्ष को कोई ना कोई मुददा चाहिए। ,35,34,1
1277,Arbitration Petition No.86 ,पंचाट याचिका याचिका संख्या 8 ,27,29,-2
1289,Ankita Lokhande is quite active on social media. ,अंकिता सोशल मीडिया पर काफी एक्टिव रहती हैं। ,49,44,5
1292,But this time things will be remarkably different ,लेकिन इस साल स्थितियां काफी बदली हुई हैं ,50,41,9
1295,For strong bones and teeth ,हड्डियों और दांतों को बनाए मजबूत ,27,33,-6
1297,Competition wise there are a lot of changes. ,प्रतियोगिता के हिसाब से काफी बदलाव हैं। ,45,40,5
1298,A special assembly was also organised. ,स्पेशल टीम का भी गठन किया गया है। ,39,34,5
1301,Mr Sharma is a member of Overseas Friends of BJP. ,शर्मा ओवरसीज फे्रंड्स ऑफ बीजेपी के सदस्य हैं। ,50,46,4
1304,Step 7: Download and take a print out. ,डाउनलोड करें और प्र‍िंंटआउट लें. ,39,33,6
1307,But no real help ultimately came forth. ,लेकिन हकीकत में इससे कुछ खास मदद नहीं मिल पाई थी। ,40,50,-10
1309,'Allegations due to misunderstanding' ,'गलतफहमी के कारण हुआ झगड़ा' ,38,28,10
1313,This is my inspiration. ,यही मेरी प्रेरणा है। ,24,21,3
1314,All is fair in love ,प्यार से हर बात को ,20,19,1
1316,Follow the right track ,सही रुटीन फॉलो करें ,23,20,3
1322,"""The car caught fire after the collision. ",टक्कर लगते ही कार में आग लग गई। ,42,32,10
1324,by friends ,दोस्तों के कारण ,11,16,-5
1325,Thousands of devotees throng shrine ,हजारों श्रद्धालुओं ने किया पिंडदान ,36,35,1
1327,This will be difficult though. ,हालांकि यह मुश्किल हैं। ,31,24,7
1329,"""The bodies were sent for postmortem. ",शवों को पोस्टमार्टम के लिए भेजा गया है। ,38,40,-2
1330,We will not leave even an inch of land. ,हम एक इंच टुकड़ा भी नहीं छोड़ेंगे। ,40,35,5
1335,"""the """"Principal Court of Civil Jurisdiction"""""" ","""""""सिविल न्यायालय के प्रधान न्यायालय"""""" ",48,40,8
1338,People rushed out of their houses in fear. ,डर की वजह से लोग अपने घरों से बाहर निकल आए। ,43,44,-1
1339,"""The process needs to be speeded up. ",इस क्रियान्वयन की गति तेज की जानी चाहिए। ,37,41,-4
1353,We are small people. ,"कहते हैं, ‘हम छोटे लोग हैं. ",21,28,-7
1355,It will be taken out. ,"""वह आउट हो किया जाएगा। ",22,23,-1
1360,No effort was made to clean it. ,इसकी सफाई के लिए कोई क़दम नहीं उठाया गया. ,32,42,-10
1367,Alcohol was found inside the car. ,गाड़ी के अंदर शराब रखी हुई थी। ,34,31,3
1375,It's a sad moment for all of us. ,हम सब के लिए ये दुखदायी क्षण है। ,33,33,0
1378,"""The court rejected the appeal. ",जिस पर कोर्ट ने अर्जी वापस कर दी। ,32,34,-2
1379,Milk and water will be sifted. ,दूध का दूध और पानी का पानी हो जाएगा. ,31,37,-6
1383,"Modi, Sushma mislead nation on Doklam: Congress ",मोदी व सुषमा ने डोकलाम पर गुमराह किया: कांग्रेस ,48,48,0
1387,me excited ,रोमांचित हूं। ,11,14,-3
1392,Sets a 4 - to - 3 video aspect ratio ,4 से 3 वीडियो ऑस्पेक्ट रेशो सेट करता है ,37,40,-3
1394,A case has not been filed yet. ,अभी केस दर्ज नहीं किया गया है. ,31,31,0
1395,But I have never forgotten it. ,लेकिन मैंने उसका पीछा नहीं छोड़ा. ,31,34,-3
1408,"""They believe the Bible is infallible. ",उसकी कविताएँ बाइबिल से अनूदित हैं। ,39,35,4
1414,I have heard carefully from all the parties. ,मैंने सभी पक्षों की बात गंभीरता से सुनी है' ,45,44,1
1421,4 held for looting passengers ,मालवाहक गाड़ी लूटने वाले 4 काबू ,30,32,-2
1422,Justice should be the same for everyone. ,अधिकार सबके लिए समान होने चाहिएं। ,41,34,7
1425,New delhi is the capital of India ,भारत की राजधानी नई दिल्ली है। ,34,30,4
1426,"""The community of nations responded as one. ",देशों के समुदाय ने एकजुट होकर जवाब दिया। ,44,41,3
1427,Chinese communists have the power of gun. ,चीनी कम्यूनिस्ट के पास बंदूक की ताकत है. ,42,41,1
1435,Just once. ,बस एक बार. ,11,11,0
1436,Restrictions further eased in Jammu and Kashmir ,जम्मू-कश्मीर: चरणबद्ध तरीके से पाबंदियों में ढील ,48,49,-1
1443,panic-struck ,भययुक्त ,13,8,5
1447,He did not even make a statement. ,यहां तक कि उसके बयान भी नहीं लिए। ,34,34,0
1451,Sajjan Kumar (Photo: PTI) ,सज्जन कुमार (फोटो: पीटीआई) ,26,27,-1
1456,She confessed to having tortured the boy. ,उसने बच्ची से दुष्कर्म करने की बात कबूल की है। ,42,47,-5
1469,"However, he faces opposition from the villagers. ",हालांकि इसका ग्रामीणों की ओर से विरोध जारी है. ,49,47,2
1470,"""The prize money of this award is rupees 10 lacs. ",इस मैराथन की ईनामी राशि 10 लाख रूपए होगी। ,50,42,8
1473,Friends advice worked ,सहपाठियों की सलाह काम आई ,22,25,-3
1478,"""The farmers said their ",किसानों का कहना है कि गांव ,24,27,-3
1482,This lowers the risk of breakouts. ,इससे कटने-छिलने की आशंका कम होती है। ,35,37,-2
1490,Sometimes yes. ,अलबत्ता कभी-कभी। ,15,17,-2
1492,He will be produced in court on Sunday. ,शुक्रवार को उसे अदालत में पेश किया जाएगा। ,40,42,-2
1493,steep price hike ,कीमतों में जोरदार तेजी ,17,23,-6
1500,This activates metabolism. ,इससे मेटाबॉलिज्म सक्रिय हो जाता है. ,27,36,-9
1502,Many people started trolling her. ,कई लोग उन्हें ट्रोल करने लगे। ,34,30,4
1506,So how much will it contribute to revenues? ,तो इससे ब्रांड के राजस्व में कितनी बढ़त होगी? ,44,45,-1
1518,post card ,पोस्ट कार्ड ,10,12,-2
1524,Many times accidents have happened on this route. ,इस दौरान सड़क हादसे की कई घटनाएं हुई हैं। ,50,42,8
1528,"(through Regional Committee of MQM, Peshawar) ",(द्वारा एम क्यु एम प्रान्तीय कमिटी पेशावर) ,46,43,3
1529,Dividend free of tax ,कर मुक्त लाभांश ,21,16,5
1531,Hindu society will no more tolerate this. ,इसे हिंदू समाज किसी सूरत में सहन नहीं करेगा। ,42,45,-3
1534,on the right and on the left in groups? ,दाएँ और बाएँ से गिरोह के गिरोह ,40,31,9
1535,Cops sensitised on crime against women ,महिला अपराधों पर संवेदनशीलता दिखाए पुलिस ,39,41,-2
1542,You will get complete success in job or business. ,नौकरी या बिजनेस में आपको पूरी सफलता मिलेगी। ,50,44,6
1544,But the department failed to do so. ,लेकिन विभाग की ओर से यह काम नहीं किया गया। ,36,43,-7
1552,Could not create new project ,परियोजना आयात नहीं की जा सकी ,29,29,0
1554,Plan the steps involved. Anticipate obstacles. ,फिर सोचिए कि आप उन्हें कैसे पार कर सकते हैं । ,47,46,1
1558,Notes that cannot be identified for any reason ,"ऐसे नोट, जिनकी किसी भी कारण से पहचान न हो सके ",47,46,1
1561,Login with required credentials. ,मान्य क्रेडेंशियल्स के साथ लॉगिन करें. ,33,39,-6
1567,Client Submit Time ,क्लाएंट सबमिट समय ,19,18,1
1572,Indian workers stuck in Libya to be back in Aug ,लीबिया में फंसे भारतीय कामगार स्वदेश लौटेंगे ,48,45,3
1573,She was alone at home at the time. ,वर्तमान में अकेले घर में रहते थे। ,35,34,1
1578,"""They're using their hands. ",वो अपने हाथों का इस्तेमाल करते हैं | ,28,37,-9
1579,"One weapon, two guys. ","एक हथियार, दो लोग. ",22,19,3
1580,"""The films story is also like that. ",फिल्म की कहानी वगैरह भी वैसी ही थी. ,36,36,0
1587,He has not been arrested as yet. ,जिसकी अभी गिरफ्तारी नहीं हुई है। ,33,33,0
1590,elections are also due. ,चुनाव की भी होती है। ,24,21,3
1602,It was Kumble's first season with the franchise. ,फ्रेंचाइजी के साथ कुंबले का पहला सीजन था। ,49,42,7
1612,Narendra Modi's roadshow in Varanasi. ,वाराणसी में मोदी का 'मेगा रोड शो' ,38,34,4
1615,"""Then policemen also started beating him. ",पुलिसकर्मियों ने भी उन्हें पीटना शुरू कर दिया। ,42,47,-5
1617,Unable to establish service% s:% s ,सेवा% s: प्रतिष्ठापित करने में अक्षम% s ,35,40,-5
1624,Its not about one person. ,यह किसी एक व्यक्ति का नहीं है. ,26,31,-5
1636,"When we met, she was really happy for me. ",जब मैं उससे मिली तो वह मेरे लिए खुश था। ,42,40,2
1638,All this didn't happen overnight. ,यह सब कुछ रातों-रात में नहीं हुआ है। ,34,37,-3
1641,We are very saddened with his demise. ,हमें उनके जाने का बहुत दुख है। ,38,31,7
1646,Check out her latest photos... ,देखिए उनके अंतिम सफर की तस्वीरें . ,31,35,-4
1654,It can encompass many meanings. ,इसके कई अर्थ निकाले जा सकते हैं. ,32,33,-1
1662,However there was no damage. ,हालांकि इससे कोई नुकसान नहीं हुआ है. ,29,37,-8
1666,"""The day will be good in terms of health. ",सेहत के लिहाज़ से दिन अच्छा रहेगा। ,42,35,7
1669,He said a decision on this will be taken soon. ,उसने कहा कि इस पर फैसला बाद में सुनाया जायेगा. ,47,47,0
1670,His health was bad. ,उनकी तबीयत खराब है । ,20,21,-1
1678,"As a result, the rupee fell substantially. ",इसकी वजह से रुपये में जबरदस्त कमजोरी आई थी। ,43,44,-1
1679,Audio Signal flow ,श्रव्य/ऑडियो संकेत प्रवाह ,18,26,-8
1680,Create swap space ,स्वैप जगह बनाएँ ,18,16,2
1683,He has been made a minister of state. ,उन्‍हें राज्‍यमंत्री बनाया गया है। ,38,35,3
1692,We all need to work together to make this happen. ,हम सभी को आपस में मिलकर यह कार्य पुरे करने होंगे। ,50,50,0
1693,Women are worshiping Corona as Mai. ,महिलाएं बाकायद कोरोना माई की पूजा करती हैं। ,36,44,-8
1696,View statistics ,आँकड़े देखें ,16,13,3
1700,and I take it as a sign that we 're among friends ,और इसे मित्रवत व्यवहार का लक्षण मानता हूँ कि ,50,45,5
1701,Motorcyclist killed in collision ,टक्कर में मोटरसाइकिल चालक की मौत ,33,33,0
1712,(Music ends) (Applause) Thank you. ,(संगीत समाप्त होता है) (तालियां) धन्यवाद। ,35,42,-7
1713,Home Minister Rajnath Singh in Lok Sabha. ,लखनऊ में गृहमंत्री राजनाथ सिंह। ,42,32,10
1714,"In the next election, the BJP will be defeated. ",अगले चुनाव के बाद बीजेपी झाग की तरह बह जाएगी. ,48,46,2
1721,"In China, its already happened. ",चीन में ऐसा हो भी चुका है। ,32,27,5
1722,Thinking of you ,तुम्हारे बारे में सोचना ,16,24,-8
1723,"""The politics of Maharashtra is changing. ",महाराष्ट्र की सियासत में बड़ा उलटफेर हुआ। ,42,42,0
1724,Rio has denied making any such statement. ,रिजवी ने ऐसे किसी बयान से इनकार किया है. ,42,41,1
1729,"""The truth always triumphs. ",सच्चाई की हमेशा जीत होती है…। ,28,30,-2
1731,This violates the Constitution. ,ऐसा करना संविधान का उल्लंघन होगा। ,32,34,-2
1734,"Section - 276AB, Income-tax Act, 1961-2018 ","धारा - 276कख, आय-कर अधिनियम, 1961-2018 ",43,39,4
1737,I think it has been quite successful. ,मुझे लगता है कि यह काफी सफल था. ,38,32,6
1742,and Our armies shall be the victors. ,और निश्चय ही हमारी सेना ही प्रभावी रहेगी ,37,41,-4
1755,"""They should be educated under the Wardha Scheme. ",उन्हें वर्षा-पद्धति से शिक्षा देनी चाहिये। ,50,43,7
1763,"""The Government has to look into this seriously. ",प्रशासन को इस दिशा में गम्भीरता से सोचना चाहिए। ,49,48,1
1769,"Agent 32, we send the package. ","एजेंट 32, हम पैकेज भेज. ",31,24,7
1777,For transaction amount upto Rs.2000/- -: ,2000/ रुपये से अधिक राशि के लेन-देन के लिए -: ,41,46,-5
1778,"""The village lacks basic facilities. ",इस गांव में बुनियादी सुविधाओं का अभाव है। ,37,42,-5
1788,It shouldnt be. ,यह नहीं होना चाहिए । ,16,21,-5
1789,Heres a report card. ,ये है रिपोर्ट कार्ड :- ,21,23,-2
1796,I havent interacted with them. ,उनके साथ संबंध नही बदले हैं। ,31,29,2
1800,This in itself is amazing. ,अपने आप में कमाल है। ,27,21,6
1808,"New Delhi, October 16 ","नयी दिल्ली,16 अक्तूबर (एजेंसी) ",22,31,-9
1809,Winter: probably India. ,इसका आदिस्थान संभवत: भारत ही है। ,24,33,-9
1810,What work they do? ,वे क्या काम करते हैं? ,19,22,-3
1824,"Mahatma Gandhis statue defaced in Kannur, Kerala ",केरल में महात्मा गांधी की प्रतिमा क्षतिग्रस्त ,49,46,3
1825,"Section - 293A, Income-tax Act, 1961-2018 ","धारा - 293क, आय-कर अधिनियम, 1961-2018 ",42,38,4
1829,Everyone stood up. ,सभी लोग उठ खड़े हुए. ,19,21,-2
1830,Shah Rukh Khan with family ,फैमिली के साथ दिखे शाहरुख खान ,27,30,-3
1831,"Chapter 11, infra. ",आगे अध्याय 11। ,19,15,4
1843,"Clearly, something is woefully wrong. ","स्पष्ट है, कहीं न कहीं चूक तो हुई है। ",38,38,0
1844,Everyone wanted freedom of the country. ,"हरेक का जज्‍बा था, देश आजाद हो। ",40,32,8
1845,Please enter a valid update - key: ,एक वैध अद्यतन कुंजी दर्ज करेंः ,35,31,4
1847,For any problem there are many solutions. ,उसके पास हर समस्या के कई समाधान होते हैं। ,42,42,0
1851,Photo: From social media ,फोटो: सोशल मीडिया से ,25,21,4
1860,"""The main battle is between BJP and Congress. ",मुख्य मुकाबला कांग्रेस और भाजपा के बीच ही। ,46,43,3
1870,Somewhere safe. ,कहीं सुरक्षित। ,16,15,1
1871,"""The police said one accused has been arrested. ",पुलिस ने आरोपी को गिरफ्तार कर लिया है। ,48,39,9
1872,Of how much more worth are you than birds? ,न उनके पास भंडार है और न अनाज के कोठे । ,43,40,3
1878,But this thinking is wrongheaded. ,लेकिन उनकी यह सोच गलत है। ,34,26,8
1902,Amendment of section 193. ,धारा 193 का संशोधन। ,26,20,6
1913,He didnt have any qualms about it. ,उसको किसी तरह की कोई परेशानी नहीं थी। ,35,38,-3
1919,coconut oil ,नारियल तेल- ,12,12,0
1921,So theres a problem. ,इसलिए थोड़ी समस्या है। ,21,23,-2
1923,"""The victim is a Class 10 student. ",अनमोल कक्षा 10 के छात्र हैं। ,35,29,6
1929,What is Referendum 2020? ,क्या है जनमत संग्रह 2020? ,25,26,-1
1930,"""There is a deep sense of anguish among people ",लोगों के भीतर काफी गहरे गुस्से का भाव है ,47,41,6
1943,"""They have started the investigation. ",उन्होंने जांच शुरू कर दी है। ,38,29,9
1946,"""The actor had taken his own life on June 14. ",उन्होंने 14 जून को आत्महत्या कर ली। ,46,36,10
1951,Ratan Tata invests in CarDekho.com ,कारदेखो डॉट कॉम में टाटा का निवेश ,35,34,1
1957,Chahal got us back in the game. ,चहल ने हमें खेल में वापस ला दिया। ,32,34,-2
1960,"""The winners were awarded with medals. ",विजेताओं को स्मृतिचिन्ह देकर सम्मानित किया गया। ,39,48,-9
1961,Watch this report. ,"देखिए, ये रिपोर्ट। ",19,19,0
1963,This is based on a true incident. ,यह एक सच्ची घटना पर आधारित है. ,34,31,3
1969,This was not without reason. ,यह तिरस्कार सकारण था। ,29,22,7
1976,Please support. ,प्लीज सपोर्ट करें। ,16,19,-3
1980,"At this stage, work is a priority for both of us. ",इस पड़ाव पर हम दोनों के लिए काम प्राथमिकता पर है. ,50,50,0
1986,What happened was bad. ,"जो हुआ, बहुत बुरा हुआ। ",23,23,0
1989,Filesystem label ,फ़ाइलतंत्र लेबल ,17,16,1
1994,Motorcycle rider died in the road accident ,रोडवेज की टक्कर से साइकिल सवार बुजुर्ग की मौत ,43,46,-3
1995,It was her husband's second marriage. ,यह उसके पति की दूसरी शादी थी। ,38,30,8
1998,Couldnt watch the video till the end. ,अंत तक यह वीडियो नहीं देख सकता हूं। ,38,36,2
2012,Still thousands of litre of water goes waste. ,"""वहीं हजारों लीटर पानी बर्बाद हो रहा है। ",46,41,5
2022,India is a democratic country. ,भारत एक लोकतांत्रिक देश है। ,31,28,3
2028,Will take care of them? ,इनकोदूरकबकरायाजाएगा? ,24,21,3
2038,But the medication takes time to produce results. ,लेकिन इस दवा का परिणाम निकलने में वक़्त लगता है । ,50,50,0
2040,It has many advantages. ,इसमें खूबियों की भरमार है। ,24,27,-3
2051,Consider this also. ,ये भी तो सोचिए। ,20,16,4
2055,It has a week of seven days. ,एक सप्ताह में सात दिन होते हैं। ,29,32,-3
2071,As many as 13 persons were killed in the attack. ,इस हमले में अभी तक 13 लोगों की मौत हो गई है। ,49,45,4
2072,Show Image Viewer ,छवि प्रदर्शक दिखाएँ ,18,20,-2
2081,But it was cancelled at the last moment. ,हालांकि अंतिम क्षण में उन्होंने इसे रोक लिया था। ,41,49,-8
2085,Paste Error ,चिपकाने में त्रुटि ,12,19,-7
2098,You also see. ,आप भी देखें. ,14,13,1
2102,Are you coming back tomorrow? ,क्या तुम कल लौट आ रही हो? ,30,26,4
2106,Usually an ,आमतौर एक इंसान के … ,11,20,-9
2108,Wear full sleeves clothes ,पहनें पूरी आस्तीन के कपड़े ,26,27,-1
2112,Who gained and who lost? ,किसको हुआ फायदा और किसको नुकसान ,25,32,-7
2121,Thanks for the courage. ,शुक्रिया हिम्मत बढ़ाने के लिये। ,24,31,-7
2133,"No, My Lord! ",‘नहीं मेरे बाप! ,13,16,-3
2141,Will the Congress agree to this? ,कांग्रेस क्या इसी में प्रतियोगिता करेगी? ,33,41,-8
2142,Sanjay was badly injured in the assault. ,इस हमले में हड़बड़ गंभीर रूप से घायल हो गया। ,41,43,-2
2145,"""The committee submitted its report last week. ",समिति ने पिछले महीने अपनी रिपोर्ट सौंपी है। ,47,44,3
2166,It has to take an immediate decision. ,इसमें तो फ़ौरन फ़ैसला होना चाहिए। ,38,34,4
2167,"""The country will never accept this. ",देश यह स्वीकार नहीं करेगा। ,37,27,10
2168,MEA wont elaborate on Modi-Xi meet ,जर्मनी में नहीं मिलेंगे शी-मोदी ,35,32,3
2171,"Programme of Cooperation with CDTI, Govt. ",स्‍पेन सरकार के सीडीआईटी 'सहयोग कार्यक्रम' ,42,43,-1
2176,"""The first Prime Minister, Pt. ",पहले प्रधानमंत्री पं. ,31,22,9
2181,Style of Cell ,कक्ष की शैली ,14,13,1
2193,week (s) ,सप्ताह ,9,7,2
2194,God is infallible. ,ईश्वर अनासक्त है। ,19,18,1
2202,Main focus on social distancing ,सोशल डिस्टेंसिंग पर खास जोर ,32,28,4
2208,In a statement here ,यहां जारी एक बयान में वन ,20,25,-5
2220,Panic has gripped the area after the incident. ,इस वारदात के बाद इलाके में सनसनी मची हुई है। ,47,45,2
2223,Also read ,आप भी पढ़ लीजिए… ,10,17,-7
2224,"""The matter was reported to the police. ",इस मामले की सूचना पुलिस को दी गई। ,40,34,6
2233,"Today, I see a Mini India before me. ","आज अपने सामने, मैं मिनी इंडिया को देख रहा हूं। ",37,47,-10
2238,Suicide will not solve the problems. ,खुदकुशी करने से कोई समस्या नहीं सुलझती। ,37,40,-3
2246,Thats why more land is needed. ,इसके लिए और जमीन की जरूरत है। ,31,30,1
2247,Are you doing? ,क्या आप करते हैं ? ,15,19,-4
2248,He had been convicted on this charge. ,"""वह इस आरोप के दोषी पाए गए थे। ",38,31,7
2251,"""The film is set in a rural backdrop. ",फिल्म ग्रामीण परिवेश पर बनी है. ,38,32,6
2252,Heavy Rainfall warning in the north-east ,पूर्वी हवा में उड़ गया भारी बारिश का रेड अलर्ट ,41,47,-6
2253,Recruitments Statistics ,भर्ती सांख्यिकी ,24,16,8
2256,Social Security Agreement with Germany ,जर्मनी के साथ सामाजिक सुरक्षा समझौता ,39,37,2
2262,People love Modi. ,मोदी से नफरत है। ,18,17,1
2269,It could not be identified. ,पता लगाना संभव नहीं था। ,28,24,4
2274,"""The 3G smartphone has a 2500 mAh battery. ",सैमसंग गैलेक्सी एम02एस में है 5000 एमएएच की बैटरी ,43,50,-7
2275,"""The situation is similar in Maharashtra. ",महराष्ट्र में भी ऐसी ही स्थिति बनी हुई है। ,42,43,-1
2276,That is why he was punished. ,इसलिए उसको ये सजा दी गयी है। ,29,29,0
2279,How did you get involved? ,आप इससे किस तरह जुड़े? ,26,22,4
2280,Beneath A Steel Sky ,इस्पाती आकाश के नीचे ,20,21,-1
2282,"However, there are other aspects also. ",किन्तु इसके कुछ दूसरे पहलू भी हैं। ,39,35,4
2286,People are not fools. ,जनता कोई बेवकूफ नहीं है। ,22,25,-3
2297,He's innocent. ,"""वह बेखौफ है। ",15,14,1
2298,A youth was arrested by police there. ,जहां पुलिस ने एक युवक और युवती को धर दबोचा. ,38,44,-6
2299,Eating fruit-fruit will make you feel refreshed. ,फल-फ्रूट खाने से आप खुद को तरोताजा महसूस करेंगे । ,49,50,-1
2300,"However, no one has been reported injured. ",हालांकि किसी के हताहत होने की खबर नहीं. ,43,40,3
2301,Rizavana Tabassum is an independent journalist ,(रिज़वाना तबस्सुम स्वतंत्र पत्रकार हैं ,47,38,9
2302,National Service Delivery Gateway ,राष् ट्रीय सेवा प्रदायगी गेटवे ,34,31,3
2305,This time the schools were closed. ,"उस समय स्कूल बंद थे, इस बार खुले थे। ",35,37,-2
2309,"""The journey has been great fun. ",यह सफ़र सुपर मजेदार रहा है। ,33,27,6
2311,Hyderabad House ,दिल्ली का हैदराबाद हाउस ,16,24,-8
2317,Neha Thackeray ,नेहा ठाकुर ,15,11,4
2320,What PDP has to say ,क्या कहना है बीडीपीओ का ,20,24,-4
2327,Its not those fours and sixes. ,यह उन चौकों और छक्कों की नहीं है। ,31,34,-3
2332,We will go by constitution. ,हम संविधान से चलते हैं। ,28,24,4
2342,"""The court sentenced him to life imprisonment. ",कोर्ट ने उन्हें आजीवन कारावास सजा सुनाई था. ,47,44,3
2356,"""The shooting for the film began this month. ",इस फिल्म की शूटिंग बीते महीने शुरू हो चुकी है। ,45,47,-2
2358,From films to politics ,सिनेमा से सियासत ,23,17,6
2360,International Cricket Debuts ,अंतराष्ट्रीय क्रिकेट का आगाज़ ,29,30,-1
2377,This process will continue further. ,यह प्रक्रिया निरंतर जारी रहेगी। ,36,32,4
2378,Use the specified device ,निर्दिष्ट उपकरण इस्तेमाल करें ,25,30,-5
2380,Telecom and IT ,टेलीविज़न और कंप्यूटर ,15,21,-6
2382,interim accommodation ,अंतरिम वित्तीय निभाव ,22,21,1
2383,Capital Subsidy ,पूंजी आर्थिक सहायता ,16,20,-4
2387,Hike in petrol prices likely ,पेट्रोल के दाम में हो सकती है वृद्धि ,29,37,-8
2389,Who or what inspired you? ,किससे प्रेरणा मिली या लेती हैं? ,26,32,-6
2402,Super30 was really a good movie. ,’ अजूबा एक सुपरहीरों फिल्म थी। ,33,31,2
2403,Fonts for toolbars ,औजारपट्टी के लिए फ़ॉन्ट ,19,24,-5
2417,Detection of Cyclone in Coastal Areas ,समुद्र तटवर्ती क्षेत्रों में तूफान का पता लगाना ,38,48,-10
2427,How's that sound? ,मैं कैसे है कि ध्वनि है ,18,24,-6
2433,French police are still investigating. ,’ फ्रांस पुलिस मामले की जांच कर रही है। ,39,40,-1
2436,Nitish Kumar makes split with BJP official ,भाजपा छोड़ 'MMS' बनाने की फिराक में नीतीश कुमार ,43,48,-5
2439,Check out their latest photos. ,देखें उनकी ताजा तस्वीरें ,31,25,6
2442,Ive stopped going to the movies. ,फिल्मों में आने से रोका। ,33,25,8
2445,I had never acted even in a school play. ,मैंने स्कूल टाइम में कभी प्ले भी नहीं किया। ,41,44,-3
2446,Scale like structure. ,पैमाने के समान संरचना। ,22,23,-1
2448,"""The woman does exactly that. ","""वह कन्या ऐसा ही करती है। ",30,26,4
2449,Downloading utility ,अधोभारण उपयोगिता ,20,17,3
2460,"RASHI, Chandigarh ","रश्मि, चंडीगढ़ ",18,15,3
2462,He has destroyed himself. ,नाश हुआ स्वयं उनका। ,26,20,6
2465,Once the oil is hot add chopped garlic. ,तेल के गर्म होते ही उसमें कटा हुआ प्याज डालें। ,40,47,-7
2466,"""Their conservation is responsibility of all. ",इसे बनाए रखना सभी की जिम्मेदारी है। ,46,36,10
2475,This was discussed. ,इस पर चर्चा की गई. ,20,19,1
2476,Why do you go on living? ,क्यों जी रहे हैं? ,25,18,7
2477,"""Their voices are not heard. ",उनकी गुहार सुनी नहीं जा रही है. ,29,32,-3
2479,Category: Governorates of Lebanon ,श्रेणीःलेबनान के प्रान्त ,34,25,9
2482,"Vientanne (Laos), June 1 ","भिवानी, 1 जून (हप्र) ",25,21,4
2485,Thats part of the job. ,वर्कशाप इसी का हिस्सा है। ,23,26,-3
2492,"""They do not have any leader. ",उनके पास कोई नेतृत्व नहीं है. ,30,30,0
2493,Anti-Irish sentiment ,विरोधी आयरिश भावना ,21,19,2
2513,Learn about these places. ,जानिए इन जगहों के बारें में। ,26,29,-3
2521,CBI Court to hold... ,सीबीआई ने कोर्ट को . ,21,21,0
2522,I have never experienced anything of this sort. ,मुझे इस तरह का कोई अनुभव नहीं हुआ है। ,48,38,10
2542,Many persons and policemen were injured. ,कई स्थानीय लोग एवं पुलिसकर्मी घायल हुए थे। ,41,43,-2
2552,This is fascism. ,यही है फासीवाद है. ,17,19,-2
2553,This release issued at 1045 hrs. ,यह विज्ञप्ति 1045बजे जारी की गई। ,33,33,0
2555,'He Is God? ,‘कर बाय गॉड? ,12,13,-1
2567,Enable sticky switching ,एक्स- केबी विकल्प सक्षम करें (E) ,24,33,-9
2569,No one had. ,किसी को अलॉट नहीं थी। ,12,22,-10
2571,"Hinderer of the good, transgressor, sinful, ",हद से बढ़ने वाला गुनेहगार तुन्द मिजाज़ ,44,39,5
2574,"""There are no side effects. ",इनका कोई साइड इफेक्‍ट भी नहीं होता. ,28,36,-8
2577,Aquarius: You will achieve success at work. ,कुंभ:कार्यभार में सफलता के साथ यश भी मिलेगा। ,44,45,-1
2579,Remedial Measures: ,चेचक के उपाय: ,19,14,5
2582,Almost every tank has a control box. ,चाहर गोत्र एक जाट गोत्र है। ,37,28,9
2583,"""The modern life is a very busy one. ",आधुनिक लाइफस्टाइल भागदौड़ भरी है. ,37,34,3
2584,It also softens the skin. ,त्वचा में भी निखार आता है। ,26,27,-1
2585,Exposure to yoga ,योग का अनुभव ,17,13,4
2592,She didnt return home. ,"""वह फिर लौटकर भी नहीं आया। ",23,27,-4
2599,One person has been detained in the matter. ,मामले में एक व्यक्ति को गिरफ्तार किया गया ,44,42,2
2600,Around 2000 children participated in the event. ,इसमें करीब 2000 हजार बच्चों ने भाग लिया था। ,48,44,4
2612,How should a Christian wait for God? ,एक मसीही को परमेश्‍वर की बाट कैसे जोहनी चाहिए? ,37,47,-10
2640,We met Sanjay Raut. ,हम संजय राउत जी से मिले हैं। ,20,29,-9
2651,death of children clarified ,मृतक बच्चों की हुई पहचान ,28,25,3
2654,"""Theyre healthy and in good spirits. ",वो जिंदा हैं और स्वस्थ हैं। ,37,28,9
2655,This was done very quietly. ,यह काम अत्यंत कुटिलता से किया गया। ,28,35,-7
2663,So everyone thought. ,जो सब सोच रहे थे। ,21,18,3
2671,"""The first Test to be played there. ",इस स्थल पर पहला टेस्ट खेला जाएगा। ,36,34,2
2681,Show this help message ,इस मदद संदेश को दिखाएं ,23,23,0
2684,Would love it. ,यह प्यार है. ,15,13,2
2704,Wood #2 ,लकड़ी # 2 ,8,10,-2
2705,I am very thankful to them. ,मैं उनकी बहुत शुक्रगुज़ार हूं. ,28,31,-3
2709,Avoid risky investments. ,जोखिम भरे निवेशों से बचकर रहें। ,25,32,-7
2711,"Ready, get set, [SOUND]. ","तैयार, [ध्वनि], तैयार हो जाओ. ",25,30,-5
2713,OpenGL extensions ,ओपन-जीएल एक्सटेंशन्स ,18,21,-3
2715,We will take all proper steps. ,हम सभी आवश्यक कदम उठाएंगे। ,31,27,4
2716,"""He asked them, """"Don't you understand, yet?"""""" ","उस ने उन से कहा, क्या तुम अब तक नहीं समझते? ",48,44,4
2718,What does spirituality mean to you? ,तुम आध्यात्मिकता को क्या समझोंगे? ,36,34,2
2726,Ministry of Commerce & Industry ,वैज्ञानिक एवं औद्योगिक अनुसंधान विभाग ,32,38,-6
2727,"""The government stands with farmers. ",शासन-प्रशासन किसानों के साथ है। ,37,32,5
2729,"Shivin Narang, actor ",टीवी एक्टर शिविन नारंग ,21,23,-2
2732,Ghosh chooses not to talk about them ,घोष उनके बारे में बात नहीं करते हैं। ,37,37,0
2737,"So, this impasse continues. ",यह सिलसिला अनवरत जारी रहता है। ,28,31,-3
2740,This is low-level politics. ,यह एक निचले दर्जे की राजनीति है। ,28,33,-5
2744,All three images: Bettmann / CORBIS ,तीनों तसवीरें: © Bettmann / CORBIS ,36,35,1
2746,"""They are currently lodged in Meerut jail. ",इन दिनों उनकी पोस्टिंग मेरठ कैंट में है। ,43,41,2
2747,TOEFL (Test of English as a Foreign Language) ,टेस्ट ऑफ इंग्लिश एज फॉरेन लैग्वेज (टोएफल) ,46,42,4
2767,"Hemanth Kumar, ",हेमंत कुमार को… ,15,16,-1
2771,Why have you been off films. ,आपने फिल्मों से दूरी क्यों बना रखी है? ,29,39,-10
2773,Mayor inaugurates development works ,विधायक ने किया विकास कार्यों का उद्घाटन ,36,40,-4
2778,Ram is of Shabari as well as of Sugreeva. ,"राम शबरी के हैं, सुग्रीव के भी हैं। ",42,36,6
2780,"""The BJP does not have winning candidates. ",भाजपा में उम्मीदवारों की कोई कमी नहीं है। ,43,42,1
2784,Youth dies in bike-truck collision ,वैन की टक्कर से बाइक सवार युवक की मौत ,35,38,-3
2786,A similar event was held in New York as well. ,ऐसा ही एक मामला न्यूयॉर्क से सामने आया है। ,46,43,3
2798,He decided to affiance her at Niagara falls. ,उसने नियाग्रा जलप्रपात पर सगाई का फैसला किया। ,45,46,-1
2801,This story is not an isolated one. ,यह कहानी अकेले रचिता की नहीं है. ,35,33,2
2805,Risk to commence from date of D. D. / P. O. ,डी. डी./पी. ओ. की तारीख से शुरू ख़तरा ,44,38,6
2806,How was the experience working with Anil Kapoor? ,कुणाल कपूर के साथ काम करने का अनुभव कैसा रहा? ,49,46,3
2812,I love this part of the competition. ,मैं इस चैम्पियनशिप के लिए बहुत उत्सुक हूं। ,37,43,-6
2813,132 people have recovered. ,1327 लोगों की मौत हो गई है। ,27,28,-1
2815,Every person has value and importance. ,हर भारतीय का मूल्य और महत्त्व है। ,39,34,5
2821,It is offered with a 5-speed manual gearbox. ,इसमें 5 स्पीड मैन्युअल गियर बॉक्स दिया गया है। ,45,47,-2
2824,"""The police also arrested three men. ",तीन अन्य युवकों को भी पुलिस ने दबोचा ,37,37,0
2825,He is from a very poor family. ,"""वह अति गरीब परिवार से है। ",31,27,4
2840,"""They both are entangled with each other. ",ये दोनों आपस में जीजा-साला हैं। ,42,32,10
2843,He was shot in the head. ,उनकी बाजू में गोली लगी है। ,25,27,-2
2851,Rename Session ,सत्र का अंत ,15,12,3
2854,Bike rider killed in accident ,दुर्र्घटना में बाइक सवार की मौत ,30,32,-2
2863,Disconnect computer modems and power sources. ,कंप्यूटर मोडॆम और पावर सोर्सॆस काट दीजिए । ,46,43,3
2866,China going to make trade deal with US: Trump ,चीन के साथ व्यापार समझौते के करीब अमेरिका ः ट्रंप ,46,50,-4
2867,Watch the video to find out why ,देखें विडियो और जानें इसका कारण ,32,32,0
2874,He has also received several awards. ,उन्हें कई पुरस्कारों से भी नवाजा जा चुका है। ,37,45,-8
2875,"""The government should think about this. ",इस पर सरकार को विचार करना चाहिए। ,41,33,8
2876,I do not like you. ,मैं तुम्हें पसंद नहीं करती । ,19,29,-10
2878,Questions asked by MLAs has ,विधायकों ने पूछे ये सवाल ,28,25,3
2879,This is an issue of national honour. ,यह देश की प्रतिष्ठा से जुड़ा मसला है. ,37,37,0
2880,But I could do no more for them. ,पर इससे अधिक मैं उनके लिए कुछ नहीं कर सका। ,33,43,-10
2883,"""""""If I had to isolate with somebody?"" ",'क्या मुझे किसी से सगाई कर लेनी चाहिए थी? ,39,42,-3
2887,Take him to the PEOC. ,इन्हें पीऑक ले जाओ। ,22,20,2
2889,"""The reason? ",यह कमी क्यों? ,13,14,-1
2892,"""The entire society must unite for this cause ",इस कार्य के लिए पूरे समाज को एकजुट होना होगा। ,46,46,0
2897,He got 90 on his English test. ,उसे अंग्रेज़ी में नब्बे अंक मिले। ,31,34,-3
2903,A decision will be taken only after that. ,इसके बाद ही कोई एक फैसला लिया जाएगा। ,42,37,5
2905,Not tough to arrest ,'सरगना को पकड़ना आसान नहीं' ,20,28,-8
2920,Im very excited about that. ,मैं इसको लेकर बहुत उत्साहित हूं। ,28,33,-5
2921,Whats there to understand? ,इसमें समझने वाली क्या बात है। ,27,30,-3
2926,Why is there no debate on these issues? ,"""वहां ऐसे विवाद क्यों नहीं होते? ",40,33,7
2928,He changed many jobs. ,उन्होंने कई ठिकाने बदले. ,22,25,-3
2938,Its a crime. ,यह तो अपराध है. ,13,16,-3
2944,Police did not lodge an FIR. ,पुलिस ने हमारी एफआईआर नहीं लिखी. ,29,33,-4
2951,India lost to Pakistan in the semi-final. ,भारत को सेमीफाइनल में हार का सामना करना पड़ा। ,42,46,-4
2952,"Need a lift anywhere, Miss? ","आपको कहीं छोड़ दूँ, सुश्री? ",28,27,1
2954,Whats the reason for it? ,क्या वजह है इसकी? ,25,18,7
2955,"""The film is directed by Rumi Jaffery. ",फिल्म ‘चेहरा' का निर्देशन रूमी जाफरी ने किया है. ,39,49,-10
2959,Dont add fuel to the fire. Kerrin. ,आग में घी डालने का काम मत कीजिए । ” — कोमल । ,35,45,-10
2960,Counting of votes is underway in the five states. ,पांचों राज्यों में वोटों की गिनती शुरू हो गई है। ,50,49,1
2962,[ Picture on page 27] ,[ पेज 29 पर बक्स] ,22,18,4
2963,Even Bollywood celebrities joined in. ,इसमें बॉलीवुड सेलेब्स भी शामिल हुए। ,38,36,2
2984,Latin'holmia 'for the old name of Stockholm ,स्टॉकहोम का लेटिन में पुराना नाम 'होलमिया' ,44,43,1
2986,"235 vs England, 2016 ",235 रन विरुद्ध इंग्लैंड ,21,24,-3
2990,India ranks fourth. ,भारत समाचार चौथे नंबर पर है. ,20,29,-9
2993,"""The police have arrested the youth. ",पुलिस ने उक्त युवक को काबू कर लिया है। ,37,39,-2
2994,"""How Fast Is It Compared To Pi2B?""""."" ","देखना है ज़ोर कितना, बाज़ु-ए-क़ातिल में है? ",38,44,-6
3012,BCCI granted paternity leave to Virat Kohli. ,बीसीसीआई ने विराट कोहली को आराम दिया है। ,45,41,4
3015,All my stuff was inside my bag. ,मेरा सारा सामान बैग में ही था। ,32,31,1
3018,Citizen charter in Hindi ,"हिन्दी में उपलब्ध नागरिक संहिता, ",25,33,-8
3019,Please suggest some funds. ,आप कुछ फंडों की सलाह दें। ,27,26,1
3021,"""There is an airport. ","""वहाँ भी एक हवाई अड्डा है। ",22,27,-5
3034,"""The Scheme of the Competition Act ",प्रतियोगिता अधिनियम की योजना ,35,29,6
3035,It is a very serious matter. ,यह एक गंभीर स्थिति है। ,29,23,6
3042,Kalinga Institute of Industrial Technology (KIIT) ,कलिंगा औद्योगिक प्रौद्योगिकी संस्थान (केआईआईटी) ,50,48,2
3045,% s of% s -% s% s ,का% s-% s ,18,10,8
3054,"""The file could not be found. ",फ़ाइल नहीं मिल सकी. ,30,20,10
3055,I'm not sick. ,मैं रोगी नहीं हूं। ,14,19,-5
3056,Unable to initialize ,मूल्य बाइंड करने में अक्षम ,21,27,-6
3064,All survived. ,सब बच जाते हैं। ,14,16,-2
3071,"""The movie is directed by Indra Kumar. ",इस मूवी को इंद्र कुमार डायरेक्ट करेंगे। ,39,40,-1
3078,Whether the text is editable ,क्या पाठ्य संशोधनीय है ,29,23,6
3086,NSIC signs MoU with Mitutoyo South Asia ,एनएसआईसी और मितुतोयो दक्षिण एशिया के साथ साझेदारी ,40,50,-10
3096,Read our Apple iPhone 6 review. ,वीडियो में देखिए आईफोन 7 का रिव्यू: ,32,36,-4
3105,"""The man is currently lodged in jail. ",यह व्यक्ति फिलहाल जेल में बंद है। ,38,34,4
3108,Marsh made 39 off 41 balls with six fours. ,मेंडिस ने 41 गेंद में चार चौकों से 39 रन बनाए। ,43,47,-4
3128,What else can be said about it? ,इसके बारे में और क्या कहा जा सकता है. ,32,38,-6
3129,He was undergoing treatment there. ,"""वहां उसका इलाज चल रहा था। ",35,27,8
3132,mmediately once the instrument is received. ,लिखत के प्राप्त होने के तुरंत बाद ,44,34,10
3139,VNC Password VNC ,कूटशब्द ,17,8,9
3142,Data Entry Operator ,डाटा एंट्री ऑपरेटर- ,20,20,0
3145,In the Preserved Tablet. ,जो लौहे महफूज़ में लिखा हुआ है ,25,30,-5
3156,"""These were sacrifices of sincere praise. ",ये सच्चे दिल से की जानेवाली स्तुति के बलिदान थे । ,42,50,-8
3162,"NEET MDS was conducted on December 14, 2018. ",NEET MDS को 14 दिसंबर 2018 को आयोजित किया गया था। ,45,50,-5
3166,Yes sir! ,‘सो तो है साहब! ,9,16,-7
3167,"""Then, when one blast is sounded on the Trumpet, ",फिर जब सूर में एक (बार) फूँक मार दी जाएगी ,49,42,7
3180,But then that wasn't enough. ,लेकिन यह प्रयास अपर्याप्त रहे। ,29,31,-2
3182,New names ,नए नामों की सिफारिश ,10,20,-10
3186,How will that come about? ,ऐसी ज़िंदगी कैसे मुमकिन है? ,26,28,-2
3187,India have also crossed the 200-run mark. ,भारत का स्कोर 200 पार कर गया है. ,42,33,9
3190,Rs 3.56/litre cut in diesel price likely ,डीजल के दाम में 3.56 रुपये की कटौती जल्द ,41,41,0
3201,"""These have been airlifted. ",उन्हें एयरलिफ्ट किया गया है। ,28,29,-1
3214,"As long as he stays, I will be happy. ",जब तक वह रहेगा तब तक मैं ख़ुश रहूँगी । ,38,38,0
3216,Something's in the Woods 15. ,यह दुर्ग १५ एकड़ में फैला हुआ है। ,29,34,-5
3218,All these things have happened. ,इस तरह यह सब कुछ हुआ। ,32,22,10
3220,So we should go for that. ,इसलिए हमें वहां जाने की जरूरत है. ,26,34,-8
3230,Match was very exciting till the end. ,मैच अंतिम ओवर तक काफी रोमांचकारी रहा। ,38,38,0
3241,This film... ,"""वह इस फिल्म . ",13,15,-2
3243,"""They have even starred together in many films ",दोनों ने साथ में कई फिल्मों में काम किया है। ,47,45,2
3247,of life ,ज़िंदगी के साथ ,8,14,-6
3260,"""The BSP has 21 members in the Lower House. ",राज्यसभा में बसपा के 15 सदस्य हैं। ,44,35,9
3264,Nobody listens to poor. ,गरीबों की कोई सुनने बाला नहीं है। ,24,34,-10
3279,Bigg Boss Season 13 is currently on a roll. ,बिग बॉस सीजन 13 में लगातार घमासान मचा हुआ है। ,44,46,-2
3281,He ruined lives. ,उसने जीना हराम कर दिया था. ,17,27,-10
3285,Private DSA Key ,निजी DSA कुंजी ,16,15,1
3287,I've... ,मैंने इसकी . ,8,13,-5
3290,Rebellion against child marriage ,बाल विवाह के खिलाफ मुहिम ,33,25,8
3293,This is how people on Twitter reacted. ,ट्विटर पर लोगों के ऐसे रिएक्शन्स आए हैं . ,39,42,-3
3298,"""The economy is bad. ",अर्थव्यवस्था के बुरे हाल हैं. ,21,30,-9
3300,from all across the country. ,देश के सभी स्थानों के हैं. ,29,27,2
3301,"""The cause of the death hasnt been revealed yet. ",मौत के कारणों का अभी तक खुलासा नहीं हुआ है। ,49,44,5
3314,Doctors withdraw strike ,डॉक्टरों ने वापस ली हड़ताल ,24,27,-3
3316,Is that even possible. ,क्या यह भी संभव है। ,23,20,3
3318,It is likely to move in a westward direction. ,इसके दक्षिण दिशा में आगे बढ़ने की संभावना है। ,46,46,0
3321,"""Their future is in utter darkness. ",उनका भविष्य अंधकार से भरा होता है। ,36,35,1
3331,It has great capacity. ,उसमें काफी क्षमता है. ,23,22,1
3335,What is politics? ,नीति क्या है. ,18,14,4
3342,I miss the family. ,परिवार को चलाया। ,19,17,2
3345,"""There was drought in Gujarat. ",गुजरात में रेगिस्तान था। ,31,25,6
3346,Put ghee in the pan and heat it. ,पैन को गैस पर रखकर गर्म करें। ,33,30,3
3347,India imports so much of electrical goods. ,"भारत, चीन से मशीनरी का काफी अधिक आयात करता है। ",43,47,-4
3353,Why the ban? ,नाकेबंदी क्यों? ,13,16,-3
3358,"""The police who arrested four people. ",चार लोगों को गिरफ्तार किया गया है। ,38,35,3
3360,Which will be very fruitful. ,जो की काफी फलदायी होगा। ,29,24,5
3366,His political journey started then. ,जिसके बाद उनके सियासी सफर की शुरुआत हुई. ,36,41,-5
3367,"For me, the stigma is personal. ","मेरे लिए, कलंक व्यक्तिगत है। ",32,29,3
3369,Senior district officials also reached the spot. ,घटनास्थल पर जिले के आला अफसर भी पहुंच रहे हैं. ,49,47,2
3378,Several other PUDA officials were also present. ,इसके अलावा डीडीसीए के कई पदाधिकारी भी मौजूद रहे। ,48,49,-1
3379,How the testing is done ,कैसे निर्धारित होता है टेस्ट ,24,29,-5
3385,Thank you people of Latur for this faith & trust. ,लातूर की जनता का इस भरोसे के लिए धन्यवाद। ,50,42,8
3386,Try to maintain peace in your family. ,परिवार में सामंजस्य बिठाने की कोशिश करें. ,38,42,-4
3388,Help on this application ,इस अनुप्रयोग पर मदद ,25,20,5
3389,"""The cleaner came into the synagogue. ",सफाई कर्मचारी पूजा स्थल में आया. ,38,33,5
3390,Log in to your Twitter account. ,आप अपने ट्विटर अकाउंट में लॉगिन करें। ,32,38,-6
3400,Lockdown has not yielded results: Rahul Gandhi ,लॉकडाउन से कोई नतीजा नहीं निकला: राहुल गांधी ,47,45,2
3408,How delighted we were to receive it! ,इस नयी किताब को पाकर हम फूले न समाए थे! ,37,40,-3
3410,[ Box / Picture on page 5] ,[ पेज 5 पर बक्स / तसवीर] ,27,25,2
3415,Can you teach me how to steal? ,क्या तुम मुझे चोरी करना सिखा सकते हो? ,31,38,-7
3416,It also has Wi-Fi. ,इसमे वाईफाई लगा है। ,19,20,-1
3423,Vegetables anything you choose ,सब्ज़ियां- जो भी आपको पसंद हों लें ,31,35,-4
3425,Ill make my own destiny. ,मैं अपना भाग्य खुद बनाउंगी। ,25,28,-3
3431,List of enclosures ,ंलग्नकों की सूची ,19,17,2
3441,Sexual immorality is death dealing! ,लैंगिक अनैतिकता घातक होती है! ,36,30,6
3467,"""The guests awarded the winners. ",विजेताओं को अतिथियों ने सम्मानित किया। ,33,39,-6
3469,Director: Vikram Bhatt ,निर्देशक : विजय भट्ट ,23,21,2
3470,"April 28, 2008 May 4, 2008 ","28 अप्रैल, 2008 – 4 मई, 2008 ",27,29,-2
3479,Principal District Judge/Principal Judges ,प्रधान जिला न्यायाधीश / प्रधान न्यायाधीश ,42,41,1
3480,Computer teachers end protest ,मांगों को लेकर प्राध्यापकों का धरना ,30,36,-6
3484,"""The other accused will also be arrested soon. ",अन्य आरोपितों को भी जल्द गिरफ्तार कि या जाएगा। ,47,47,0
3489,"""The condition of two persons is serious. ","""वहां पर दो लोगों की हालत गंभीर बनी है। ",42,40,2
3492,Drunk son kills father ,शराब पीकर बाप को बेटे ने पीटा ,23,30,-7
3501,(With inputs from news agencies) ,(समाचार एजेंसियों से इनपुट के साथ) ,33,35,-2
3506,"Bank of India, Central ","केंद्रीय बैंक, फंड ",23,19,4
3507,He is currently admitted in a hospital. ,जिसे फिलहाल अस्पताल में ही रखा गया है. ,40,39,1
3517,"""The same old story was repeated. ","""वही पुरानी कहानियां दोहराई जा रही हैं। ",34,40,-6
3521,Color of neutral cubes. ,न्यूट्रल घन के लिए रंग ,24,23,1
3523,"""There are two changes in the Indian team. ",इंग्लैड की टीम में दो बदलाव हुए हैं। ,43,37,6
3526,"Meaning of resisted as far as blood , 2 / 15 ","प्राचीन संसार का नाश हुआ (जलप्रलय), 3 / 1 ",45,42,3
3537,2 cinnamon sticks ,2 चुटकी हींग ,18,13,5
3539,Deepika Padukone shared this photo. ,दीपिका पादुकोण ने शेयर की फोटो ,36,31,5
3544,Purchase of residential flats in Lucknow ,लखनऊ में आवासीय फ्लैटों की खरीद ,41,32,9
3549,It was originally the manuscript room. ,इसका पहिला मुख्य दफ्तर पलासियो दे सांता करूस था। ,39,49,-10
3555,Have some respect for your education. ,कुछ तो अपनी शिक्षा की कद्र कीजिए। ,38,34,4
3560,Congress is in power at present in Punjab. ,पंजाब में कांग्रेस प्रभावशाली स्थिति में है। ,43,45,-2
3564,Billy Murali paid me ,बिली मुरली मुझे भुगतान ,21,23,-2
3568,He stressed upon the need for girls' education. ,उन्होंने बेटियों की शिक्षा पर जोर दिया। ,48,40,8
3573,"""The film is directed by Akshat Verma. ",फ़िल्म का निर्देशनअमित वी मासूरकर ने किया था। ,39,46,-7
3581,"that He is the Lord of Sirius, ",और ये कि वही योअराए का मालिक है ,31,32,-1
3584,For dull skin ,बेदाग त्वचा के लिए ,14,19,-5
3585,A car later rammed into the trucks. ,वाहन फिर पीछे से एक ट्रक में घुस गया। ,36,38,-2
3588,Also the farmers do not get any benefit from it. ,साथ ही इससे किसानों को एक पैसा भी नहीं मिलेगा. ,49,47,2
3590,this is too easy as well as difficult ,यह ‎अत्यंत आसान है और यह बहुत कठिन भी है। ,38,42,-4
3598,Take them out of the syrup and serve hot. ,इन्हें तेल से निकाल कर गर्मागर्म परोसें। ,42,41,1
3602,No talking with other inmates. ,अन्य कैदियों से बात नहीं करते। ,31,31,0
3607,BA (Hons) Social Work- 70% ,बीए (ऑनर्स) सोशल वर्क- 70% ,27,27,0
3612,Planned to go abroad ,विदेश में बसने की थी योजना ,21,27,-6
3616,"But no, indeed, you shall soon know. ",देखो तुमको अनक़रीब ही मालुम हो जाएगा ,37,37,0
3620,I did ask him about it. ,मैंने भी पूछ ही लिया। ,24,22,2
3623,He was smiling. ,"""वह हो-हो कर हंसा। ",16,19,-3
3626,"""The change must come from society. ",बदलाव समाज में आना चाहिए. ,36,26,10
3634,He brought the cash to his vehicle. ,यह नगदी उसने अपनी कार में रख ली। ,36,33,3
3641,We have forgotten to issue notice. ,"पीठ ने कहा, ‘‘हम नोटिस जारी करना भूल गये थे। ",35,45,-10
3642,But thats how the game is. ,लेकिन खेल की दुनिया ही ऐसी है. ,27,31,-4
3649,"""The programme was pre-set. ",यह कार्यक्रम पहले ही तय हो गया था. ,28,35,-7
3651,"New Delhi/Mumbai, Jan 29 ","मंडी डबवाली, 29 जनवरी (निस) ",25,28,-3
3652,During this ,इस दौरान यहा… ,12,14,-2
3656,"Now we are doing it, he had said. ",उन्होंने कहा कि चलिए अभी करते हैं। ,34,35,-1
3657,Additional PM Kisan helpline number: 0120-6025109 ,पीएम किसान की एक और हेल्पलाइन है: 0120-6025109 ,50,47,3
3670,BJP behemoth ,बीजेपी का मेनिफेस्टो ,13,21,-8
3679,Thats the question. ,यही सवाल पूछते हैं। ,20,20,0
3680,Red hot priority demand ,अति अग्रता माँग ,24,16,8
3692,He has been buried in Yerwada jail. ,उसे येरवड़ा जेल में फांसी हुई थी। ,36,34,2
3711,We were very happy with the response we got. ,जो रेस्पॉन्स मिला उससे हम सब खुश हैं। ,45,38,7
3713,Many people were reportedly injured. ,कई लोगों के घायल होने की सूचना भी मिल रही है। ,37,46,-9
3727,He was born in 1920. ,"""वह १९२० मे जन्म हुआ। ",21,22,-1
3728,I have never quit the job. ,मैंने कभी काम करना बंद नहीं किया है। ,27,37,-10
3738,He is completely all in. ,"""वह पूरी तरह से तंदरूस्त हैं। ",25,30,-5
3746,This is your responsibility. ,इस की ज़िम्मेदारी आप की है। ,29,27,2
3756,Directory to remove from configuration file ,डिरेक्ट्री जिसे कॉन्फ़िगरेशन फ़ाइल से मिटाना है ,44,48,-4
3759,Step 2: Click on the results section. ,स्टेप 2- रिजल्ट लिंक के सेक्शन पर क्लिक करें. ,38,46,-8
3767,Ex-Army official killed in land feud ,सीढिय़ों से गिरने के चलते पूर्व सैनिक की मौत ,37,44,-7
3769,My family is extremely happy. ,मेरी फैमिली बेहद कंज़र्वेटिव है। ,30,33,-3
3783,Unsupported clipboard format. ,असमर्थित क्लिपबोर्ड प्रारूप। ,30,29,1
3785,Id seen this with my own eyes. ,मैंने अपनी आँखों से देखा है। ,31,29,2
3792,He has not talked to anyone about it. ,अभी तक इस बाबत किसी से बात नहीं की है. ,38,39,-1
3808,Police is currently probing the case. ,फिलहाल पुलिस मामले की तलाश कर रही है। ,38,38,0
3814,Congress has also backed the move. ,इस बंद का कांग्रेस ने भी समर्थन किया। ,35,38,-3
3816,This is also Naturally. ,यह स्वाभाविक भी है। ,24,20,4
3818,Recoverable payment ,वसूली योग्य अदायगियां ,20,22,-2
3822,she 's got seven kids. ,और उस के सात बच्चे हैं। ,23,24,-1
3823,"""They said her health condition is deteriorating. ",बताया जा रहा है कि उनकी तबीयत और खराब हो गई है। ,50,48,2
3824,Ish Sodhi (Base price Rs 50 lakh) ,ईश सोढ़ी (बेस प्राइस 50 लाख रुपये) ,34,35,-1
3839,No tension. ,नो टेंशन । ,12,11,1
3846,move over ,स्थान बदल ,10,10,0
3853,ready-made ,तैयार ,11,6,5
3856,S. Yadav Vs ,जेएस यादव बनाम ,12,15,-3
3858,Photo- ANI ,फोटो- एएनआई ,11,12,-1
3860,Technology Development for Indian Languages ,भारतीय भाषाओं के लिए प्रौद्योगिकी विकास ,44,40,4
3864,All this discussion is absurd. ,इस तरह की सारी चर्चा बेबुनियाद है। ,31,35,-4
3869,"""The solution to the problem? ",इसका सर्वोत्तम समाधान क्या है? ,30,31,-1
3876,"""The Orissa High Court ",उड़ीसा उच्च न्यायालय ,23,21,2
3879,"""The BJP, however, disagrees. ",हालांकि बीजेपी इसपर राजी नहीं है. ,30,34,-4
3886,So science was born. ,विज्ञान का जन्म हो गया। ,21,24,-3
3889,One arrested with 2-kg opium ,2 किलो अफीम के साथ एक काबू ,29,27,2
3893,"It is based in Manhattan, New York City. ","इसका मुख्यालय मैनहैटन, न्यू यॉर्क शहर में है। ",41,46,-5
3906,One suspect has been arrested in the case. ,मामले में एक आरोपी की गिरफ्तारी हो चुकी है. ,43,44,-1
3909,SC to hear plea for CBI probe in Batchas death ,बाशा की मौत के मामले में हो सीबीआई जांच : स्वामी ,47,49,-2
3913,"we 've taken millions of breaths, collectively, ","हमने सम्मिलित होकर लाखों श्वास लीं हैं, ",48,40,8
3915,Preparation for this has started. ,इसके लिए तैयारी शुरू की। ,34,25,9
3921,We have to be united to face them. ,इनका सामना करने के लिए हमें एकजुट होना होगा। ,35,45,-10
3922,Chapter 6: Where Are the Dead? ,अध्याय 6: मरे हुए कहाँ हैं? ,31,28,3
3923,Availability of Fertilizers in Domestic Market ,घरेलू बाजार में उर्वरकों की उपलब्‍धता ,47,38,9
3943,8 times 3 is 24 plus 4 is 28. ,8 गुना 3 है 24 जमा 4 है 28. ,30,28,2
3944,Aurangabad train incident ,घटना औरंगाबाद के अंकोरा रेलवे ,26,30,-4
3956,"But its not only him, its the team. ",सिर्फ उन्‍हें ही नहीं बल्कि पूरी टीम को। ,36,41,-5
3968,"so serve you God, and obey you me. ",अतः अल्लाह का डर रखो और मेरा कहा मानो ,35,38,-3
3984,BJP leader Shahnawaz Hussain ,भाजपा नेता सैयद शाहनवाज हुसैन। ,29,31,-2
3987,This release issued at 1835 hrs ,यह विज्ञप्ति 1835 बजे जारी की गई। ,32,34,-2
3990,Laws are changing. ,कानून बदले जाते हैं। ,19,21,-2
3994,New Zealand vs Australia ,बनाम न्यूज़ीलैंड (अाकलैंड) ,25,26,-1
3997,We have no intention to do that. ,हमारा ऐसा इरादा नहीं है। ,33,25,8
4003,Woman arrested for beating husband ,सास की पिटाई करने के आरोप में महिला गिरफ्तार ,35,45,-10
4012,"""The film is also available on Netflix. ",ये फिल्म नेटफ्लिक्स पर भी उपलब्ध है. ,40,37,3
4014,This time we are together. ,इस बार हम मुक़ाबले में हैं. ,27,27,0
4016,"""They won't even get the opportunity to hit back. ",उन्हें अजस्ट करने का भी मौका नहीं मिल पाता है। ,50,47,3
4020,Dont die ,मरा तो नहीं। ,9,13,-4
4021,Charles was married to Catherine De Berganza. ,चार्ल्स का विवाह कैथरीन डे बर्गैन्ज़ा से हुआ था। ,46,49,-3
4022,He is a pious devotee of Sri Ranganatha. ,वे श्री रंगनाथ के धर्मात्मा भक्त हैं। ,41,38,3
4025,Police were informed about the incident. ,इस घटना की सूचना थाने में दी गई। ,41,33,8
4031,Continue with this process. ,यह प्रक्रिया लगातार करते रहें। ,28,31,-3
4033,A good day for married couple. ,नवविवाहित जोड़ों के लिए दिन अच्छा है। ,31,38,-7
4039,"And, Bond, you have to find L'Americain. ","और बॉन्ड, तुम्हें लमेरिकेन को ढूँढ़ना होगा। ",41,44,-3
4040,Why is this door open? ,यह दरवाजा खुला क्यों है? ,23,25,-2
4042,can 't read from file descriptor% d ,फ़ाइल विवरणकर्ता% d से पढ़ा नहीं जा सकता है ,36,44,-8
4046,Woman commits suicide with 3 children ,3 बच्चों समेत महिला ने की खुदकुशी ,38,34,4
4054,Also read: How will a BSP-SP alliance shape up? ,यह भी पढ़ें: सपा-बसपा की राह हुई अलग? ,48,38,10
4057,I'm sure he won't be too angry at me. ,मुझे यकीन है कि वह मुझसे नाराज नहीं होगा। ,38,42,-4
4064,Turn it on. ,इसको आप ऑन कर दें। ,12,19,-7
4069,That is why he made that statement. ,यही वजह है कि उन्होंने खुद ही बयान दे डाला. ,36,44,-8
4081,"Ekta Kapoor, producer ",एकता कपूर हैं इसकी प्रोड्यूसर ,22,30,-8
4085,"It happened here, too. ","""वह यहां भी हुआ। ",23,17,6
4089,What is the impact on children? ,बच्चों पर क्या होता है प्रभाव? ,32,31,1
4094,Can you understand what Im saying? ,आप समझ सकते हैं कि हम क्या कहना चाह रहे हैं? ,35,45,-10
4095,It has that history to it. ,उसका ऐसा करने का इतिहास है। ,27,28,-1
4103,You have to be involved. ,शामिल होना होगा। ,25,17,8
4118,"Jattana meets CM, seeks relief ",प्रधानमंत्री से मिले सीएम ,31,26,5
4125,House Owner ,घर की मालकिन को ,12,16,-4
4128,Look again ,दोबारा देखिए। ,11,14,-3
4131,That was me. ,यह मैं ही था। ,13,14,-1
4133,Slamming baby pigs to ground ,सूअर के बच्चे को धरती पर पटकना ,29,31,-2
4134,"""There were no means of transportation there. ","""वहां पर आने-जाने का कोई साधन नहीं था। ",46,39,7
4135,This gives energy. ,इससे एनर्जी मिलती है। ,19,22,-3
4138,This is Congress party. ,ह है कांग्रेस पार्टी। ,24,22,2
4142,"""The BJP is expected to get 106 seats ",बसपा 90 सीटों पर चुनाव लड़ती आई है ,38,35,3
4143,At least 35 people were injured in the fire. ,इस धमाके में कम से कम 35 लोग जख्मी हुए हैं. ,45,44,1
4158,Sakshi Sharma ,शशि कामरा ,14,10,4
4159,"Hence, the allegations are totally false. ",इसलिए यह आरोप पूरी तरह से झूठा है. ,42,35,7
4190,Some technical problems are also apparent. ,जांच में कुछ तकनीकी समस्या भी आ रही हैं। ,43,41,2
4193,She is in the kitchen. ,"""वह किचन में है. ",23,17,6
4195,He also served as state attorney. ,सरकारी वकील के तौर पर भी उन्होंने सेवा दी। ,34,43,-9
4201,It also has moisturising properties. ,इसमें ब्लीचिंग गुण भी होते हैं। ,37,32,5
4204,"So, I was forced to hide my family. ",इसलिए मुझे अपने परिवार को छिपाना पड़ा. ,36,39,-3
4212,Will this not generate jobs? ,क्या इससे नौकरियां नहीं आ रहीं? ,29,32,-3
4221,"""The reasons for the suicide are not known. ",खुदकुशी करने के कारणों का खुलासा नहीं हो पाया है। ,44,50,-6
4223,A bar in London. ,लंदन का एक बार। ,17,16,1
4224,"""The message reads: """"I love you."" ","संदेश में लिखा था, 'मैं आपसे प्यार करता हूँ. ",35,45,-10
4225,EPI means Every Person is Important. ,EPI मतलब ऐवरी पर्सन इज इम्पॉर्टेंट। ,37,36,1
4228,Greater attention to need based programmes. ,आवश्यकता अनुरूप कार्यक्रमों पर अधिक ध्यान। ,44,43,1
4230,But let's not get ahead of ourselves. ,"लेकिन, चलो खुद से आगे नहीं। ",38,28,10
4242,Gold investment demand set to surge ,निवेश मांग से सोने में आएगा उफान ,36,33,3
4244,"""The fear was not unfounded ",’ आशंका निर्मूल न थी: ,28,22,6
4248,But headship does not mean dictatorship. ,लेकिन मुखियापन का मतलब तानाशाही नहीं है । ,41,42,-1
4251,"After that, click on the result link. ",फिर रिजल्ट लिंक पर क्लिक करें। ,38,31,7
4253,And it 's at the scale of the night sky. ,और रात के आसमान के पैमाने पर है। ,41,33,8
4261,"New Delhi/Kolkata, September 13 ","कोलकाता, 9 सितंबर (भाषा)। ",32,26,6
4268,for the entire city. ,पूरे गांव के लिए। ,21,18,3
4276,What do you...? ,क्या बात... ? ,16,14,2
4279,Everyone needs to understand this. ,ये बात किसी भी व्यक्ति को समझना चाहिए। ,35,39,-4
4281,Not just for her but for her family too. ,न केवल वे बल्कि उनका परिवार भी. ,41,32,9
4282,How would it affect our work? ,अब इसका हमारे काम पर कैसा असर होता? ,30,36,-6
4283,McGraths wife loses cancer battle ,» कैंसर से लड़ाई हारीं मैकग्रॉ की पत्नी ,34,40,-6
4285,"""Their turnover was also one of the highest. ",ईसीआईएल की आज तक टर्नओवर भी सर्वाधिक थी। ,45,41,4
4286,That gets top priority. ,उन्हे पहली प्राथमिकता देते हैं. ,24,32,-8
4287,People die all the time. ,जनता तो हरपल मृत्यु. ,25,21,4
4298,38 killed as train rams into bus ,"ट्रेन की चपेट में आयी बस, 38 की मौत ",33,36,-3
4299,Three held for planning robbery ,लूट की योजना बनाते तीन काबू ,32,28,4
4304,Inflation rises ,बढ़ती ही जा रही है महंगाई ,16,26,-10
4305,Tyres of 2 vehicles stolen in Mohali ,आधी रात को 2 वाहनों के टायर चोरी ,37,33,4
4309,Three incidents have been reported in Delhi. ,दिल्ली में तीन तलाक का मामला सामने आया है. ,45,43,2
4310,"However, their bodies were never recovered. ",हालांकि इनके शवों को बरामद नहीं किया जा सका. ,44,45,-1
4311,electric cell ,बैटरी ,14,6,8
4317,"""The report exposed another thing. ",रिपोर्ट में एक और तथ्य उजागर हुआ है. ,35,37,-2
4323,"""The phone has 32GB built-in storage. ",फोन की इनबिल्ट स्टोरेज 32 जीबी है। ,38,35,3
4324,What were these flaws? ,ऐसी क्या खामियां रह गईं? ,23,25,-2
4325,Our bench strength has improved a lot as well. ,हमारी बेंच स्ट्रेंथ भी बेहतर हुई है. ,47,37,10
4326,Do you want that? ,क्या आप वैसा चाहते हैं? ,18,24,-6
4328,Facebook has denied the charge. ,फेसबुक ने इस कमी को दूर कर लिया है। ,32,36,-4
4329,We have lots to do. ,हमें काफी कुछ करना है। ,20,23,-3
4333,Category:Imaginery Poet ,श्रेणी:छायावादी कवि ,24,20,4
4338,"Shri Rajnath Singh, Home Minister ","श्री राजनाथ सिंह, गृह मंत्री ",34,29,5
4343,We got only 64 matches. ,लेकिन हमें सिर्फ 64 मैच मिले। ,24,30,-6
4347,You can make this at home too. ,यह आपके घर में भी कर सकते है। ,31,30,1
4349,"""They kept saying you can do it. ",वे लगातार कहते थे कि तू ये कर सकता है। ,33,39,-6
4359,It should tell the government where it is wrong. ,सरकार को यह बताना चाहिए कि क्या गलत हो रह है. ,49,46,3
4361,What was this volley? ,यह बग क्या था? ,22,15,7
4378,And how it works. ,और कैसे काम हो। ,18,16,2
4383,Narendra Modi supporters. ,नरेंद्र मोदी के समर्थक ,26,23,3
4390,Futuristic budget for all: Modi ,सबके सपने साकार करने वाला बजट: मोदी ,32,36,-4
4397,Police said ,पुलिस की उक्त… ,12,15,-3
4400,"""The Akali Dal-BJP combine is in power in Punjab. ",प्रदेश में अकाली दल-भाजपा गठबंधन सत्ता में है. ,50,47,3
4405,"""The demands are: ",क्या हैं मांग :- ,18,17,1
4407,"mile, miles, mi ","मील, मील, miunit-format ",16,24,-8
4409,Life is Gods precious gift. ,यह जीवन परमात्मा की अनुपम भेंट है। ,28,35,-7
4426,Benefit for both ,दोनों के लिए फायदेमंद ,17,22,-5
4430,This saves both time and money. ,इससे आपके समय और पैसे दोनों की बचत होगी। ,32,41,-9
4431,appeal has been disposed of ,अपील निपटा दी गई है ,28,20,8
4436,I am witness to this. ,मैं इसके बारे में गवाह हूँ। ,22,28,-6
4439,Im not happy about it. ,मैं इसे लेकर खुश नहीं हूं. ,23,27,-4
4442,You might improve your relationships. ,इससे आपके संबंधों में सुधार हो सकता है। ,38,40,-2
4451,He was the Defence Minister from 2014 to 2017. ,"""वह 2014 से 2017 तक रक्षा मंत्री थे। ",47,37,10
4455,"""They won the fifth place match against Iceland. ",इसे आइसलैण्ड की जनसंख्या का 5वां भाग नष्ट हो गया। ,49,50,-1
4459,"""These people are stopping people from voting. ",ये लोगों को वोट देने से रोक रहे हैं। ,47,37,10
4467,Which means Modi will remain PM till 2024. ,मोदी कहते हैं कि 2024 तक वही प्रधानमंत्री होंगे। ,43,49,-6
4473,Speculations were rife since then. ,उसके बाद से ही ऐसी अटकलें लगाई जा रही थी। ,35,42,-7
4475,Rich in vitamins ,विटामिन्स से हैं भरपूर ,17,23,-6
4477,Turmeric and milk ,हल्दी और मलाई ,18,14,4
4478,Shahjahan's tomb is also similar to this.o. ,इसके बराबर ही में शाहजहां की भी कब्र है। ,44,41,3
4479,21 flights cancelled n ,15 उड़ानें रद्द करनी पड़ीं ,23,27,-4
4485,"""Then, rinse off with plain water. ",उसके बाद सिंपल पानी से सिर धो लें. ,35,35,0
4488,world sanskrit committee ,लोकरंग सांस्कृतिक समिति ,25,24,1
4499,"""These schools dont impart religious education. ",''स्कूलों में धार्मिक शिक्षा नहीं दी जाती. ,48,43,5
4502,I dont know what to do and how to survive. ,मुझे नहीं पता कि कैसे और क्या करना है। ,43,39,4
4505,"""The only solution is social distancing. ",इससे बचने का एकमात्र उपाय सोशल डिस्टेंसिंग ही है. ,41,50,-9
4507,Whats causing this change? ,इस बदलाव की वजह क्या है? ,27,25,2
4515,Work has been initiated in this direction. ,इस दिशा में कार्रवाई प्रारंभ कर दी गई है। ,43,42,1
4516,Is that really so? ,क्या वाकई ऐसा है . ? ,19,21,-2
4521,It's nine-thirty. ,साडे नौ बज गये हैं। ,18,20,-2
4525,We must be proud of our legacy. ,हमें अपनी विरासत पर गर्व होना ही चाहिए। ,32,40,-8
4531,Flax seeds ,लौकी के बीज ,11,12,-1
4539,Financial Reports and their integrity ,वित्तीय रिपोर्टें और उनकी वस्तुनिष्ठता ,38,39,-1
4544,Ganesh Naik is an Indian politician. ,नितिन गडकरी भारतीय राजनीतिज्ञ हैं। ,37,35,2
4545,So I swear by the afterglow of sunset. ,तो मुझे शाम की मुर्ख़ी की क़सम ,39,31,8
4550,Accounts payable software ,देय लेखा सॉफ्टवेयर ,26,19,7
4554,What helped? ,किस बात ने मदद की? ,13,19,-6
4559,once this was an abode for him ,कभी यह उसका निवास स्थान था ,31,27,4
4560,But the opposite is happening. ,लेकिन होता इससे उलट ही है। ,31,27,4
4562,Let us see why? ,"आइए, देखें क्यों? ",16,18,-2
4564,Not taking risk ,जोखिम नहीं ले रहीबीजेपी ,16,24,-8
4567,"and persisted in the Great Sin, ",और बड़े गुनाह पर अड़े रहते थे ,32,30,2
4572,I wish him good luck. ,मैं उसको शुभ आशीर्वाद देती हूं। ,22,32,-10
4577,This video has been going viral. ,ये वीडियो वायरल हो गया है। ,33,27,6
4592,This is sensible. ,यह समझदारी है। ,18,15,3
4595,he says... ,"""वह कहते हैं . पढ़ें ",11,21,-10
4597,To Teach in Israel Regulation and Justice ,“ इस्राएल में कानून और न्याय सिखाए ” ,42,37,5
4603,BJP candidate from K.R. ,कांगड़ा से भाजपा प्रत्याशी किशन ,24,32,-8
4606,Assume your own responsibility for your life. ,‘अपने जीवन की जिम्मेदारी को स्वीकार करें। ,46,42,4
4618,Police have also examined his mobile phone. ,पुलिस उसके मोबाइल फोन की जांच करेगी। ,44,37,7
4625,This is the biggest lesson we have learnt. ,यही सबसे बड़ा सबक है जिसे हमने सीखा है।’ ,43,41,2
4626,Do not store the loaf in the refrigerator. ,दही फ्रिज में रखा नहीं होना चाहिए। ,43,35,8
4629,it is derivable from your password entry ,यह आपकी कूटशब्द प्रविष्टि से निकलने योग्य है ,41,45,-4
4632,"""They were taken to the Civil Hospital. ",जिन्हें सिविल अस्पताल मोगा दाखिल करवाया गया। ,40,45,-5
4633,Everyone is together. ,हर कोई साथ-साथ मौजूद है। ,22,25,-3
4635,"After that, I didnt meet him. ",इसके बाद मैं उनसे मिलने नहीं गया। ,30,34,-4
4644,"After marriage, your responsibilities increase. ",शादी के बाद कपल्स की जिम्मेदारियां बढ़ जाती हैं। ,48,49,-1
4649,Turn back! ,वापस मुड़ना! ,11,13,-2
4650,"""The liquor pouches were hidden inside the car. ",कार की डिक्की में अफीम छुपाकर रखा हुआ था. ,48,42,6
4655,"""The two parties entered into mutual agreement. ",दो पक्षकार पारस्पारिक करार के सदस्य बन गये। ,48,44,4
4658,We live on hope. ,हम उम्मीद पर कायम हैं. ,17,23,-6
4660,connected with a court of law. ,जो कानूनी/न्यायिक मामलों से संबंधित हो। ,31,40,-9
4667,"""There is no restriction on them. ",उन पर कोई रोक-टोक नहीं है। ,34,27,7
4669,Highest score in IPL ,यूएई में सर्वाधिक आईपीएल स्कोर ,21,31,-10
4670,We don't know when he will realise. ,हमें नहीं पता कि वह कब समझेंगे। ,36,32,4
4671,"It is rich in antioxidants, and vitamins. ",इसमें कई विटामिन और एंटीऑक्सिडेंट होते हैं। ,42,44,-2
4682,He thereafter departed for New Delhi. ,इसके बाद भी वह नई दिल्ली भी गए हैं। ,38,36,2
4683,(Para 4.3) Section 161: ,(पैरा 4.34.) धारा 161: ,24,23,1
4685,"San Antonio, July 24 ","सोनीपत, 24 जुलाई (हप्र) ",21,24,-3
4695,"Inside, Koreng jumped up on the television set. ",घर के अन्दर कोरेंग टेलीविज़न के ऊपर से कूदी। ,48,45,3
4697,China is Pakistans principal benefactor. ,पाकिस्तान का चीन बड़ा हिमायती है। ,41,34,7
4713,Independents are leading in 4 seats. ,निर्दलीय 4 सीट पर आगे हैं. ,37,27,10
4714,Less than a minute ,एक मिनट से कम पहले ,19,19,0
4717,"""They were not terrorists. ",पर वे आतंकवादी भी नहीं थे। ,27,27,0
4718,"Annotate Digital Video, Exchange on the NEt ","डिजिटल वीडियो पर टिप्पणी करें, नेट पर विनिमय करें ",44,50,-6
4719,Every country has that responsibility. ,”इस काम में हर देश की अपनी भूमिका है. ,39,38,1
4726,But there were other issues. ,"लेकिन, कुछ और प्रॉब्लम्स भी थीं। ",29,33,-4
4729,Kareena Kapoor Khan also stars in the movie. ,फिल्म में करीना कपूर खान भी लीड रोल में होंगी. ,45,47,-2
4731,Documents are procured. ,दस्तावेज जुटा रहे हैं। ,24,23,1
4732,I shall always remember that. ,मैं इसे हमेशा याद रखूंगा। ,30,26,4
4736,Server's local socket filename ,सर्वर का स्थानीय सॉकेट फ़ाइलनाम ,31,32,-1
4737,Police are searching for the accused. ,पुलिस की टीम आरोपी की तलाश कर रही है. ,38,38,0
4749,We want justice in this case. ,वो इस मामले में न्याय चाहते हैं। ,30,33,-3
4756,It's a political film. ,यह एक राजनीतिक फिल्म है। ,23,25,-2
4757,It is currently available in the US ,इस वक्त अमेरिका में मौजूद ,36,26,10
4758,Police have arrested the driver. ,पुलिस टीम ने चालक को गिरफ्तार कर लिया। ,33,39,-6
4762,"July 13, 2013, Chandigarh, India ","चंडीगढ़, 13 जुलाई (भाषा)। ",33,26,7
4773,faith in work ,यज्ञ में विश्वास करना ,14,22,-8
4774,India take on Pakistan in their second match. ,दूसरे वनडे मैच में पाकिस्तान ने भारत को हरा दिया। ,46,50,-4
4779,"""The woman died but the child was rescued. ",लेकिन बच्चा बच गया और महिला की मौत हो गई. ,43,42,1
4785,"""The girl lodged a complaint with police. ",लड़की पक्ष ने थाना पुलिस को तहरीर दी है। ,42,41,1
4787,"""The elections... ",चुनावों को . ,18,13,5
4794,"For me, this is not a building but Ram Temple. ",यह मेरे लिए एक इमारत नहीं राम मंदिर ही है। ,47,43,4
4797,It could be small or even tiny. ,इसे छोटा या बड़ा भी किया जा सकता है। ,32,37,-5
4811,I had to make a choice. ,अब फैसला मेरे हाथ में था । ,24,27,-3
4813,"Friends, Education develops human resources. ",साथियों शिक्षा मानव संसाधन का विकास करती है। ,45,45,0
4826,"""The pair put up 61 runs for the second wicket. ",दोनों ने पहले विकेट के लिये 61 रन जोड़े. ,48,41,7
4830,"""The police are still searching him. ",पुलिस को उन्हें ढूंढ़ने में परेशानी हो रही है। ,37,47,-10
4839,What documents you should have in handy? ,कौन-कौन से दस्तावेज आपको ले जाने होंगे साथ ,41,43,-2
4841,Tanushree Dutta accuses Nana Patekar ,तनुश्री दत्ता ने लगाए हैं आरोप ,37,31,6
4857,India too has not been spared. ,भारत भी इससे अछूता नहीं रहा है. ,31,32,-1
4861,BJP Government was in power. ,भाजपा गंठबधन की सरकार थी। ,29,26,3
4862,Why is this bluff? ,यह ग़ुस्सा क्यों है? ,19,21,-2
4871,"In his commentary on Hebrews 13: 17, J. ",इब्रानियों १३: १७ पर टिप्पणी करते हुए जे. ,40,42,-2
4874,Bharat Petroleum Corporation Ltd. ,"श्री जीन बर्नार्ड लेवी, सीईओ, ईडीएफ ",34,36,-2
4875,"I mean literally, that's four 3's. ",मैं असल मे यही कहना चाहता हूँ-ये चार 3 हैं. ,35,44,-9
4876,FC Goa look to get back to winning ways ,जीत की राह पर लौटना चाहेगा एफसी गोवा ,40,37,3
4879,Were here... ,यहां मिली . ,13,12,1
4883,"""The sales will commence on March 6. ",इसकी सेल चीन में 27 मार्च से शुरू होगी। ,37,40,-3
4887,"""The Puritans discounted his warning. ",राक्षस ने उनकी चेतावनी का उपहास किया। ,38,38,0
4890,What they've done ,क्या किया उन्होंने? ,18,20,-2
4892,An inquiry is also pending in this case. ,इस मामले पर भी सुनवाई की प्रक्रिया चल रही है। ,41,46,-5
4899,And I learnt this from MS Dhoni. ,और मैंने इसे धोनी से सीखा। ,33,27,6
4902,Security of our guests is paramount. ,हमारे मेहमानों की सुरक्षा सर्वोच्च है। ,37,39,-2
4918,DAV Public school to mark Childrens Day ,डीएवी पब्लिक स्कूल में मातृ दिवस ,40,33,7
4927,Bar Council of Andhra Pradesh ,बार काउंसिल ऑफ आंध्र प्रदेश ,30,28,2
4930,SALIENT FEATURES: ,मुख्य विशेषताएंः ,18,17,1
4940,"""The Floss ",फ्लोरिंग ,11,9,2
4941,Crapos real name is not known. ,लोंगिनुस का असली नाम ज्ञात नहीं है। ,31,36,-5
4942,Carrots have 95% water content. ,खीरा- खीरे 95% पानी से भरपूर होता है. ,32,38,-6
4945,Heres the incident: ,घटना इस प्रकार है. ,20,19,1
4947,Photo burst mode ,फोटो बर्स्ट विधि ,17,17,0
4949,I dont want say anything. ,मैं कुछ कहना नहीं चाहता। ,26,25,1
4954,"Yes, I have it. ","‘हां, मेरी है। ",16,15,1
4955,Change your Face ,अपना मुख बदलें ,17,15,2
4972,Father came up and saw what was happening. ,पिताजी वहाँ आकर देखने लगे कि क्या हो रहा था । ,43,46,-3
4976,trees start growing. ,पौधे प्रौढ़ होने लगते हैं। ,21,26,-5
4979,Shocking news. ,चौंकाने वाली खबरें। ,15,20,-5
4983,"""There is a lot of awareness among the farmers. ",इससे भी काफी किसानों में जागरूकता आई है। ,48,41,7
4994,Can't breathe. ,सांस नहीं ले पाता है। ,15,22,-7
4996,"If yes, how and when? ","यदि हॉ, तो क्‍या एवं कब तक ? ",22,29,-7
4997,"Hopefully, people will like the film. ",उम्मीद है फिल्म भी दर्शकों को पसंद आएंगी। ,38,42,-4
4999,(It is the) days last over and youre doing this? ,दिन का आखिरी पल है और आप ऐसा कर रहे हैं? ,49,41,8
5004,No exemption is possible by money deposit. ,कोई छूट पैसा जमा करने से संभव है। ,43,34,9
5010,"""The experience hasn't been bad. ",यह अनुभव भी बहुत अच्छा नहीं रहा है। ,33,36,-3
5012,"""The claim could not be independently verified. ",दावे की स्वतंत्र तौर पर पुष्टि नहीं की जा सकी है। ,48,50,-2
5016,Thanks for changing everything in my life. ,मेरी जिंदगी में सब कुछ बदलने के लिए शुक्रिया। ,43,46,-3
5020,It is not part of my life. ,ये मेरी जिंदगी का हिस्सा नहीं हैं। ,27,35,-8
5025,"Nithin Kamath, founder and CEO, Zerodha ","नितिन कामत, संस्थापक और सीईओ, जेरोधा ",40,37,3
5026,"""The police also detained two women. ",इस दौरान पुलिस ने दो महिलाओं को भी पकड़ा। ,37,42,-5
5034,Upload your photo ,अपनी फोटो सेंड करो ,18,19,-1
5037,He informed police. ,उसने पुलिस को सूचना दी। ,20,24,-4
5038,Modi supporters. ,मोदी समर्थक ,17,12,5
5041,"With my wife, Koula ","अपनी पत्नी, कूला के साथ ",20,24,-4
5049,"""There are two interesting points. ","""वहां कई रोचक शेड्स हैं. ",35,25,10
5051,Thats part of my job. ,ये मेरे काम का ही हिस्सा है। ,22,29,-7
5057,"So, I don't think there is any doubt. ",इसलिए मेरे मन में कोई संदेह नहीं है. ,38,37,1
5060,But court did not consider this. ,लेकिन जेल प्रशासन को भनक नहीं लगी। ,33,35,-2
5071,Try to cut down your expenses. ,फिजूल खर्चों को कम करने की कोशिश करें। ,31,39,-8
5077,You dont worry about me. ,मेरे होते तुम चिंता मत करना। ,25,29,-4
5082,And they overtook them at sunrise. ,ग़रज़ (मूसा) तो रात ही को चले गए ,35,33,2
5084,We both have very similar interests. ,हम दोनों के पास बहुत सारी समान चीजें हैं. ,37,42,-5
5086,"that could be explored, about beauty. ",जो सौंदर्य की परिभाषा को खोज सके. ,38,34,4
5087,Let me make this into a one. ,मुझे इसको 1 बना लेने दीजिए. ,29,28,1
5095,I cannot relate his work to anyone elses. ,उनके कार्य की तुलना अन्य से नहीं की जा सकती। ,42,45,-3
5102,"""The list will be out soon. ",जल्द लिस्ट जारी की जा सकती है. ,28,31,-3
5103,Students admitted to hospitals ,अस्पताल में भर्ती :छात्राएं ,31,28,3
5104,Petitioning creditor ,प्रार्थी लेनदार ,21,16,5
5108,"However, he was rescued. ",हालांकि वह बाल-बाल बच गया। ,25,27,-2
5109,It has been revealed in a new research. ,एक नए शोध में यह जानकारी सामने आई है। ,40,38,2
5115,How did the jolt come about? ,कैसा कलजुग आ गया है? ,29,21,8
5120,I'm sure you're tired. ,यकीनन आप थक गए हैं। ,23,20,3
5121,What should you do in such a case? ,ऐसी स्थिति में क्या किया जाए। ,35,30,5
5123,It lies to the south of the capital Shillong. ,यह राजधानी शिलांग से दक्षिण दिशा में स्थित है। ,46,47,-1
5126,"""They make this either at their homes or here. ",वे इसे या तो अपने घरों में या यहाँ बनाते हैं। ,47,46,1
5127,From Nothing to Gold ,शून्य से स्वर्ण तक ,21,19,2
5137,This is our tradition. ,यह भी हमारी परंपरा है। ,23,23,0
5143,"Besides, it doesnt matter. ",इसके अलावा उसका कोई महत्व नहीं होगा। ,27,37,-10
5151,Shes a fabulous artist and a wonderful person. ,"""वह एक शानदार कलाकार और एक बुद्धिमान महिला हैं। ",47,48,-1
5168,For how long more? ,और कितना समय…? ,19,15,4
5170,What did the budget propose? ,बजट में क्या प्रपोजल था? ,29,25,4
5175,She was married and has two children. ,"युवती शादीशुदा थी, और उसके दो बच्चे भी हैं। ",38,44,-6
5180,Beijing Subway ,बीजिंग मेट्रो ,15,14,1
5181,He said it was a serious issue. ,उन्‍होंने कहा कि यह विषय गंभीर है। ,32,35,-3
5182,Ali has three children. ,अनिल के तीन बच्चे हैं. ,24,23,1
5183,It was recorded at 1153.80 ft last week. ,गत सप्ताह जलस्तर 1153.80 फुट रिकार्ड किया गया था। ,41,50,-9
5185,"fruits and vegetables, medicines, etc. ","फलों, सब्जियों और अन्य खाद्य पदार्थों की ",39,41,-2
5187,Taking criticism ,हो रही है आलोचना ,17,17,0
5198,One basis points is 100th of a percentage point. ,(एक प्रतिशत बिंदु 100 आधार अंक के बराबर होता है। ,49,49,0
5201,What does this smack of? ,ये अकडऩ किस बात की? ,25,20,5
5202,"""The cause? A heart attack. ",उसकी मौत की वजह क्या थी? ,28,25,3
5212,Further strengthen the tourism partnership. ,पर्यटन साझेदारी को मजबूत करने के लिए प्रोत्‍साहन। ,44,50,-6
5213,Police have cordoned off the area. ,पुलिस ने आसपास क्षेत्र नाकेबंदी कर दी है। ,35,42,-7
5214,"From k is equal to 0, to n of a to the k. ","कश्मीर से 0, n के बराबर है एक कश्मीर को। ",42,41,1
5222,"""Its very tough,"""" he said."" ","उन्होंने कहा, 'यह बहुत ही कठिन है। ",29,35,-6
5223,Congratulations on your new appointment. ,आपकी नई नियुक्ति के लिए बधाई हो। शुक्रिया। ,41,43,-2
5225,"This amounted to contempt of court, he said. ",उन्होंने कहा कि यह अदालत की अवमानना है। ,45,40,5
5226,Place the TSC pump in the left side opening ,बाईं ओर के उद्घाटन में TSC पंप जगह ,44,35,9
5229,"But over time, this notion is changing. ",लेकिन वक्त के साथ-साथ ये धारणा भी बदल रही है। ,40,46,-6
5236,And that's what's revolutionary here. ,और यही यहाँ क्रांतिकारी है। ,38,28,10
5242,He taught distinctness. ,उसे बोलना सिखाया. ,24,18,6
5254,Modi takes a dig at Sonia Gandhi ,अपनी बात से मुकर गए मोदीः सोनिया गांधी ,33,39,-6
5267,"No, I mean, why are you here? ","न, मेरा मतलब, आप यहाँ क्या कर रहे हैं? ",30,39,-9
5272,"However, this isn't all. ",फिर भी यह सिलसिला थम नहीं रहा। ,25,31,-6
5281,will be announced later. ,बाद में इसकी घोषणा की जाएगी। ,25,29,-4
5289,"""They are very violent. ",वे बहुत आक्रामक हो जाते हैं. ,24,29,-5
5300,Isnt this unethical? ,क्या यह अनैतिक है? ,21,19,2
5307,Shamma Ali remained unbeaten on 0. ,"""वहीं शमी 0 पर नाबाद रहे। ",35,26,9
5309,"""The BJP doesnt have majority in Rajya Sabha. ",राजग को राज्यसभा में बहुमत प्राप्त नहीं है। ,46,44,2
5312,"""They have not been cancelled. ",उनको निलंबित भी नहीं किया गया है। ,31,34,-3
5313,"""TheRE is good news to be proclaimed! ",घोषणा करने के लिए सुसमाचार है! ,38,31,7
5315,That will not happen here ,यह सब इस शहर में नहीं होगा ,26,27,-1
5324,He left after that. ,इसके बाद वो चला गया. ,20,21,-1
5326,Insert a person from your address book. ,अपनी पता पुस्तिका से एक व्यक्ति प्रविष्ट करें ,40,46,-6
5331,Watch this video for full story. ,देखिए पूरी कहानी इस वीडियो में. ,33,32,1
5335,But I cant say too much. ,लेकिन मैं ज्यादा नहीं बता सकता। ,25,32,-7
5340,"""There were tears in his eyes. ",उसकी आंखों में आंसू आ गए। ,31,26,5
5342,"""The officials squirmed. ",अफसरों की शामत आ गई. ,25,21,4
5345,"One, two, three, four. ","एक, दो, तीन या चार नंबर पर। ",23,28,-5
5347,"""The First Court ",पहला न्यायालय ,17,14,3
5351,Thats a long time ago. ,यह काफी पहले की बात है. ,23,24,-1
5352,We're the ones that pour ourselves into it. ,हम लोग ही उनमें स्वयं को उंडेल देते हैं ,44,40,4
5355,"""The victim has sustained 90 per cent burns. ","""वहीं, पीड़िता 90 प्रतिशत जल चुकी है। ",45,38,7
5357,Small beginning ,एक छोटी शुरुआत ,16,15,1
5362,"I should be arrested then, too. ",तब मुझे भी गिरफ्तार किया जाना चाहिए . ,32,38,-6
5365,Man of the Match ,'मैन ऑफ द मैच' . ,17,17,0
5370,"Paired Organs comprises of kidney, eyes etc. ","युग्मांगों में वृक्क, नेत्र आदि सम्मिलित हैं ",45,45,0
5377,Lets work together. ,आइए मिल कर काम करें। ,20,21,-1
5382,Amritsar Vs ,अमृतसर बनाम ,12,12,0
5388,"""The governing body, 1950 s ",1950 के दशक का शासी निकाय ,28,26,2
5389,All trains and flights have been suspended. ,सभी हवाई और ट्रेन सेवाएं बंद की गईं ,44,36,8
5391,"India win toss, elects to bat first ","भारत ने टॉस जीता, पहले बल्लेबाजी का फैसला ",36,42,-6
5392,"Fatehgarh Sahib, September 11 ","झज्जर, 11 सितंबर (हप्र) ",30,24,6
5395,It is famous because it houses eleven Shiv Lingas ,यह अपने ग्यारह शिवलिंगों के कारण प्रसिद्ध है। ,50,46,4
5398,I entered politics to serve the people. ,राजनीति में जनसेवा के लिये आया हूं। ,40,36,4
5399,Analog Surround 6. 1 ,एनालॉग सर्राउंड 6.1 ,21,20,1
5404,"His condition is serious, the police said. ",पुलिस ने बताया कि अस्पताल में उसकी हालत गंभीर है। ,43,50,-7
5409,On this there was quite a lot of debate. ,इस केस को लेकर काफी बहस हुई थी. ,41,32,9
5411,But the woman was forced to marry someone else ,लेकिन किरण ने किसी दूसरी महिला से शादी कर ली। ,47,46,1
5413,But the response was overwhelming. ,पर जवाब में वो ही उदासीनता। ,35,28,7
5414,Add only if _ newer ,तभी जोड़ें जब नया हो (_ n) ,20,27,-7
5417,He was trapped. ,"""वह सकपका गयी थी। ",16,18,-2
5420,I cant even explain it. ,मैं ये भी नही बता सकता। ,24,24,0
5425,Save Draft ,मसौदा सहेजें (_ D) ,11,19,-8
5429,Keep original audio track ,मूल ऑडियो ट्रैक रखें ,26,21,5
5433,I have even written about this. ,मैंने इस बारे में लिखा भी है। ,32,30,2
5434,That?s what most people think. ,ऐसा अधिकतर लोगों का मानना होता है। ,31,35,-4
5435,Im not denying that. ,उसका मैं खंडन नहीं कर रहा हूं। ,21,31,-10
5439,"Tarn Tara, November 17 ","गुहला चीका, 17 नवंबर ",23,21,2
5451,This is his ninth IPL half-century. ,ये उनका छठा आईपीएल शतक है। ,36,27,9
5454,"When the onions brown, add the tomatoes. ",प्याज सुन्हेरा हो जाने पर उस में टमाटर डाले. ,41,45,-4
5467,of India ,"""वह भारत ",9,9,0
5470,It is set to release in May this year. ,इसका उद्घाटन इस साल मई में किया गया था. ,39,40,-1
5471,He was shifted to SMHS Hospital for treatment. ,उसे इलाज के लिए एमबीएस अस्पताल में भर्ती करवाया। ,47,49,-2
5477,We will bring back our jobs. ,हम नौकरियों को वापस लेकर आएंगे। ,29,32,-3
5481,This government is... ,सरकार के इन . ,22,14,8
5496,We hope this trend continues. ,इस रुख के जारी रहने की उम्मीद है। ,30,34,-4
5499,Whats so exciting about this? ,इसमें इतनी हैरत की क्या बात है? ,30,32,-2
5505,Sharan Bansal ,शरण बंसल ,14,9,5
5513,It was amazing experience for me. ,मेरे लिये एक अनूठा अनुभव ,34,25,9
5514,"""The testing is currently underway. ",अभी इनकी टेस्टिंग चल रही है। ,36,29,7
5527,It is matte white in colour. ,यह सफेद रंग का होता है। ,29,24,5
5531,"""They lie dormant in the mind. ",वो ज़हन में बिखरी रहती हैं. ,31,28,3
5532,Bike rider killed in motorcycle-tanker collision ,ट्रैक्टर-ट्राली से टकराकर बाइक चालक की मौत ,49,43,6
5534,"""The doors were closed. ",बस के दरवाजे बंद थे। ,24,21,3
5538,SpiceJet posts profit of Rs 109 cr ,स्पाइसजेट को 109 करोड़ रु का लाभ ,35,32,3
5542,You can also take a printout. ,इसका प्रिंटआउट भी निकाला जा सकता है. ,30,37,-7
5551,Heres the film: ,यहां फिल्म … ,16,13,3
5552,Eating healthy is key. ,हेल्दी डाइट सबसे जरूरी बात है. ,23,31,-8
5555,And why not other parts of the body? ,शरीर के दूसरे भाग साथ क्यों नहीं हैं? ,37,38,-1
5556,Jeene Do ,जीने दो ,9,8,1
5560,Could not autodetect modem device ,मॉडेम युक्ति स्वतः खोज नहीं सका ,34,32,2
5563,"""The US has told... ",अमेरिका ने कहा है कि … ,20,23,-3
5567,Teenaged girl gangraped in Khandwa ,कल्याण में नाबालिक लड़की से गैंग रेप ,35,37,-2
5568,You mean? ,आपका मतलब? ,10,11,-1
5569,This was 1985. ,यह 1985 की बात है. ,15,19,-4
5573,offer of appointment ,नियुक्ति प्रस्ताव ,21,18,3
5577,So far 25 people are arrested in this case. ,मामले में 25 लोगों की गिरफ्तारी हुई हैं। ,44,41,3
5579,Suddenly they can see! ,अचानक वे देख सकते हैं! ,23,23,0
5586,However in the afternoon the weather improved. ,हालांकि दोपहर बाद उनकी स्थिति और बेहतर हो गई थी। ,47,49,-2
5601,We are hopeful by then things will ease out. ,हमें उम्मीद है कि तब तक चीजें सुलझ जाएंगी. ,45,43,2
5608,Appealing? Hardly. ,बिलकुल नहीं । ,19,14,5
5611,People need not worry. ,लोग किसी तरह की चिंता न करें। ,23,30,-7
5615,It is their call. ,ये उन्हीं की पुकार है. ,18,23,-5
5616,Growth in urban population ,तेजी से बढ़ रही शहरी आबादी ,27,27,0
5621,GDP growth rate has slumped. ,जीडीपी की दर कम हो गई है। ,29,26,3
5628,"""They had been forgotten. ",उन्हें याद आ गया। ,26,18,8
5634,Follow the directions. ,उस गाइडलाइंस को फॉलों करें। ,23,28,-5
5635,Commuters stuck in hour-long traffic jam ,9 घंटे तक जाम से कराह उठा ट्रैफिक ,41,34,7
5637,"""The truck driver fled from the spot. ",ट्रक ड्राइवर मौके से फरार हो गया। ,38,34,4
5640,"""There are no signs of it taking off. ",इसके थमने का कोई संकेत नहीं दिखाई देता. ,38,40,-2
5649,ISI is also active in Turkey nowadays. ,आईएसआई आजकल तुर्की में भी सक्रिय है। ,39,37,2
5651,domestic violence ,घरेलू हिंसा की जड़ ,18,19,-1
5652,Stabbed with knife ,कैंची से वार ,19,13,6
5656,KEEP THE AREAS CLEAN. ,क्षेत्रों को स्वच्छ रखें। ,22,26,-4
5658,8 teachers found absent ,8 लेक्चरर मिले नदारद ,24,21,3
5660,It has got no reason to it. ,"""वह इसके लिए कारण नहीं हैं। ",28,28,0
5661,Foreign Banks ,विदेशी बैंकों ,14,14,0
5678,I thought puppies shredded everything. ,मुझे लगा पपियों ने सब कुछ कुतर दिया होगा। ,39,42,-3
5679,Tape Drive Options ,टेप ड्राइव विकल्प ,19,18,1
5685,Man kept wife prisoner at home for 50 years ,पति ने पत्नी को 50 साल तक बंदी बनाए रखा ,44,40,4
5686,Government is functioning as per law. ,आखिर सरकार संविधान के अनुसार काम कर रही है. ,38,44,-6
5692,"Guidelines, in this regard, would be formulated. ",इस संबंध में दिशा-निर्देश बनाए जाएंगे। ,49,39,10
5697,Police is investigating the whole matter. ,पुलिस सारे मुद्दे की छानबीन कर रही है. ,42,39,3
5701,My dad and I-- have a terrible relationship. ,मेरे पिताजी और मैं - एक भयानक रिश्ता है. ,45,41,4
5708,"""The incident took place on Sunday afternoon. ",घटना रविवार देर सायं की बताई गई है। ,46,36,10
5724,"Subsequently, a police team arrived at the spot. ",जिसके बाद भारी संख्या में पुलिस बल पहुंच गया। ,49,46,3
5731,"Besides, the new ",इसके अलावा नए हवाई ,17,19,-2
5732,Stiff upper lip! ,तना हुआ ऊपरी होंठ! ,17,19,-2
5735,Tiger Shroff - Jackie Shroff ,जैकी श्रॉफ-टाइगर श्रॉफ ,29,23,6
5758,I do lots of things. ,मैं कई चीजें कर रहा हूं। ,21,25,-4
5759,"Yes, I heard about it. ","हाँ, मैं इसके बारे में सुना. ",23,29,-6
5762,"But they are not out, yet. ",मगर अभी खुलकर सामने नहीं आ रहे है। ,27,35,-8
5787,forced sale ,जबरन बिक्री ,12,12,0
5797,This is an issue of national pride. ,यह राष्ट्रीय शर्म का मुद्दा है. ,36,32,4
5799,Most of them are foreign nationals. ,इनमें ज्यादातर विदेश से आए लोग होते हैं. ,36,41,-5
5808,"However, it was not maintained afterwards. ",हालांकि बाद में उसका निर्माण नहीं किया गया. ,43,44,-1
5810,And then it happened ,और फिर यह हुआ ,21,14,7
5811,You will consider starting a new work. ,नया काम शुरू करने के विषय में सोचेंगे। ,39,39,0
5813,"""The new facility has 100 beds. ",नए भवन में 100 बिस्तरों का प्रावधान होगा। ,32,42,-10
5817,Youth held for killing father ,छात्र की हत्या में एक युवक गिरफ्तार ,30,36,-6
5823,VAT varies from state to state. ,वैट राज्यों के अनुसार अलग-अलग होता है। ,32,39,-7
5825,"""The streak continues for India ",भारत के लिए कड़ा इम्तिहान ,32,26,6
5827,every freaking body! ,हर अंग बेडौल ! ,21,15,6
5828,How did that help? ,इससे उन्हें क्या मदद मिली? ,19,27,-8
5832,Preparations begin months in advance. ,इसकी तैयारी महीनों चलती है. ,38,28,10
5839,Politics is dominating life. ,राजनीति जीवन पर हावी हो गयी है. ,29,32,-3
5841,Concrete steps are needed in this direction. ,इस दिशा में ठोस पहल किये जाने की आवश्यकता है. ,45,46,-1
5844,Police personnel have been deployed there. ,जिस पर पुलिस कर्मचारी तैनात रहते हैं। ,43,38,5
5847,"But, they do not answer the question. ",लेकिन वे उस सवाल का जवाब तो दे नहीं रही हैं। ,38,45,-7
5850,A barrel equals 159 litres. ,एक बैरल यानी 159 लीटर। ,28,23,5
5851,It isnt a permanent solution. ,यह स्थाई समाधान नहीं है। ,30,25,5
5858,"""The policemen had already been suspended. ",पुलिसकर्मियों को पहले ही सस्पेंड किया जा चुका है. ,43,50,-7
5860,Group Layer ,परत कतरें ,12,10,2
5867,She could not even walk to the toilet. ,चलकर शौच करने भी नहीं जा पा रहा था। ,39,36,3
5886,Now who will feed them? ,फिर उनसे शादी कौन करेगा? ,24,25,-1
5887,It will be a competitive series. ,यह सीरीज प्रतिस्पर्धी होने वाली है। ,33,36,-3
5889,Custom Color ,अनुकूलित रंग (C) ,13,17,-4
5892,You can plan to hang out with children. ,बच्चों के साथ बाहर घूमने का प्लान बना सकते हैं। ,40,48,-8
5908,We have culture. ,अपनी संस्कृति है. ,17,18,-1
5913,She is Mother India. ,भारत माता हैं। ,21,15,6
5914,"""Their allegation is irrelevant. ",उनके दावे मायने नहीं रखते। ,33,27,6
5915,I just need to know she's alive. ,मैं तो बस वह जिंदा है पता करने की जरूरत। ,33,41,-8
5916,Have you been you one of them? ,क्या आप भी उनमें से एक थे…. ,31,28,3
5919,Crude oil rises ahead of OPEC meet ,ओपेक बैठक से पहले कच्चे तेल में तेजी ,35,37,-2
5921,"""The event was held on April 7. ",7 अप्रैल को इस शो की शुरुआत होगी। ,32,34,-2
5928,But the government was paying for them. ,लेकिन सरकार की उनसे मिली-भगत थी. ,40,33,7
5932,"""They abused me. ",उन्होंने मुझसे बदतमीजी की. ,17,27,-10
5941,Yet I worked for the party. ,तब भी पार्टी के लिए ही काम कर रहा था। ,28,38,-10
5950,"So, be mindful of them. ",इसलिये उनसे होशियार रहियेगा. ,24,29,-5
5957,Pakistan should understand this. ,यह पाक को भी समझना चाहिए। ,33,26,7
5963,This will open up new avenues for you. ,इससे आपको अपने लिए नई संभावनाएं नजर आएंगी। ,39,43,-4
5973,People were enjoying it. ,लोगों ने लिए खूब मज़े। ,25,23,2
5975,cell that they need to turn into. ,"सेल, कि वे में बारी करने की आवश्यकता। ",34,38,-4
5985,Action against people who violated the rules ,नियमों का पालन न करने वालों पर कार्रवाई ,45,40,5
5987,This news is completely false. ,ये खबर पूरी तरह से सच है। ,31,26,5
5988,Salman Khan at Sohail Khans birthday party. ,सोहेल के बर्थडे पर सलमान ने एक पार्टी दी थी। ,44,45,-1
5994,File Photo | Diptendu Dutta/AFP ,फाइल फोटो | संजीव दत्ता/ एएफपी ,32,31,1
6004,What was the reaction to your decision? ,निर्णय पर क्या प्रतिक्रियाएं रहीं? ,40,35,5
6007,Hence the confusion persists. ,इसीलिए भ्रम की स्थिति बनी रहती है। ,30,35,-5
6015,FIB(26) returns 121393 ,FIB( 26) का परिणाम होगा 121393 ,23,31,-8
6017,List of compatible devices for iOS 14 upgrade ,इन स्मार्टफोन में मिलेगा iOS 14 अपडेट ,46,38,8
6018,Create graphics and charts ,ग्राफ़िक्स तथा चार्ट बनाएँName ,27,31,-4
6021,Unexpected response from IMAP server:% s ,IMAP सर्वर से अप्रत्याशित अनुक्रियाः% s ,41,40,1
6032,"New Delhi, March 4 ","नयी दिल्ली, 4 मार्च (भाषा)। ",19,28,-9
6040,Number 3: Learn the Art of Food Preservation ,तीसरा: खाद्य परिरक्षण की कला सीखिए ,45,35,10
6049,Happiness will remain in the family. ,परिवार में आनंद छाया रहेगा। ,37,28,9
6055,Al-Baghdadi 'seriously wounded in air strike' ,आतंकी सरगना अल बगदादी हवाई हमले में घायल ,46,41,5
6056,India re-elected to key UN committee ,UN आयोग में भारत फिर से चुना गया ,37,33,4
6057,Travel Advisory for Indian nationals ,भारतीय या‌त्रियों को दी गई सलाह ,37,32,5
6058,He knew he had done the right thing. ,"""वह जानता था कि जो कुछ उसने किया वह ठीक ही था। ",37,47,-10
6065,"""There was an argument between the two. ",इस बीच दोनों की आपस में बहस हो गई। ,40,35,5
6067,He also had a strong Mumbai connection. ,मुंबई से ही उनका भी ताल्लुक़ था. ,40,33,7
6069,"""The heart is a muscle. ",हृदय मांसपेशी है। ,24,18,6
6070,Find out what is the reason behind this. ,जानिए इसके पीछे का क्या है कारण। ,41,33,8
6071,that acts as a digital eye. ,जो एक डिजिट्ल आँख का काम करता है। ,28,34,-6
6074,"If you still havent watched these, you must! ",अगर हां तो ये वीडियो आपको जरूर देखना चाहिए। ,45,44,1
6078,He is instrumental in my success. ,मेरी सफलता में इसका बड़ा योगदान है। ,34,36,-2
6082,Take a look how. ,देखिए कैसे. ,17,12,5
6085,Young woman steers Chennai's first Metro train ,चेन्नई में महिला ने चलाई पहली मेट्रो ट्रेन ,47,43,4
6088,One CRPF jawan was also killed in the encounter. ,मुठभेड़ में एक सीआरपीएफ का जवान भी शहीद हो गया। ,49,48,1
6091,India was not part of that group. ,भारत इसमें शामिल नहीं हुआ था। ,34,30,4
6095,I am not even Muslim. ,मैं मुस्‍लिम नहीं फिर भी . ,22,27,-5
6098,We have landlocked states. ,हमारे यहां landlocked स्‍टेट्स हैं। ,27,36,-9
6101,Several other homes were damaged. ,"""वहीं कई अन्य घर बरबाद हो गए हैं। ",34,34,0
6103,"Kobani (Syria), January 28 ","सोनीपत, 28 जनवरी (हप्र) ",27,24,3
6108,You will get good news related to children. ,बच्चों से जुड़ी कोई खुशखबरी आपको मिलेगी। ,44,41,3
6110,"After that, his phone was switched off ",इसके बाद उनके फोन की घंटी बजी ,39,30,9
6114,This is caused by heat and other problems. ,यह गर्मी और अन्य समस्याओं के कारण होता है। ,43,43,0
6115,Avoid making hasty business decisions. ,व्यवसायिक फैसले लेने से बचें। ,39,30,9
6117,How is lightning formed? ,ज्वालामुखी कैसे बनता है? ,25,25,0
6123,Public dealing hours per working day ,सार्वजनिक मेल जोल प्रति कार्य दिवस घण्टे ,37,41,-4
6134,"I think the process I described, ","मेरे ख्याल से जो पद्धति मैनें बताई है, ",33,39,-6
6136,Moses too was modest and humble. ,"नम्रता की एक और मिसाल है, मूसा । ",33,33,0
6140,IPL 10 marks the end of a cycle. ,आईपीएल 10 का रोमांच अपने चरम पर है। ,33,36,-3
6144,He had a desire to see India free. ,वो हर हाल में भारत को आजाद देखना चाहती थीं. ,35,44,-9
6146,He couldnt make out what it was saying. ,"""वह पढ़ नहीं सकी कि उसमें क्‍या लिखा था। ",40,41,-1
6158,Judges role ,जजों की भूमिका डा. ,12,19,-7
6160,"""Then I understood. ",तब मुझे इसका एहसास हुआ। ,20,24,-4
6166,Parliamentary democracy ,संसदीय लोकतंत्र अंग्रेजों का ,24,29,-5
6171,"""The default Kopete chat window ",डिफ़ॉल्ट के- ऑप्टी गपशप विंडोName ,32,34,-2
6174,I am very excited by this new challenge. ,मैं इस नई चुनौती के लिए उत्साहित हूं। ,41,38,3
6179,basic wages ,आधारिक मज़दूरी ,12,15,-3
6186,"Los Angeles, January 7 ","लंदन, 7 जनवरी (एजेंसी) ",23,23,0
6190,Modi agreed ,मोदी हुए सानंद ,12,15,-3
6199,"360360dpi, high resolution paper ","360×360डीपीआई, उत्तम रेजोल्यूशन कागज ",33,37,-4
6205,Two persons have been rescued. ,दो लोगों की जान भी गई है। ,31,26,5
6210,"So, whatever there all put together. ","तो, जो कुछ भी एक साथ रखा जाता है। ",37,34,3
6211,Where is that money coming from? ,वैसे यह धन आता कहां से है? ,33,27,6
6213,"Hence, such situations should be avoided. ",इसलिए हमें ऐसी स्थिति को आने से रोकना होगा. ,42,44,-2
6222,About 100 doctors attended the programme. ,इसमें करीब 100 डाक्टरों ने भाग लिया। ,42,37,5
6223,It purifies the blood. ,इससे खून साफ होता है। ,23,22,1
6225,I am ready to cooperate. ,मैं सहयोग करने के लिए तैयार हूं। ,25,33,-8
6229,BJP to launch jehad against corruption ,"भेदभाव, भ्रष्टाचार के खात्मे को भाजपा वचनबद्ध ",39,46,-7
6231,"""""""We are condemning all such incidents."" ",‘हम ऐसी घटनाओं की पूरी तरह से निंदा करते हैं. ,42,46,-4
6232,Most of them have become global conglomerates ,उनमें से ज्यादातर कंपनियां वैश्विक दिग्गज बन गईं। ,46,50,-4
6233,"He said, It is an excellent move. ","""उन्होंने कहा, """"यह एक उत्कृष्ट कदम है।"" ",34,41,-7
6238,This period will be good for your children. ,यह समय आपकी सन्तान के लिए भी फेवरेबल रहेगा। ,44,44,0
6258,Education has a big importance in life. ,जीवन में शिक्षा ही सर्वोपरि है। ,40,32,8
6263,"""The government should think about this. ",सरकार को यह बात भी दिमाग में रखनी चाहिए। ,41,41,0
6265,From where did the kur come? ,कहां से आती है कुरजां ,29,22,7
6271,Developing countries ,विकसित देशों ने तो ,21,19,2
6275,PM Modis social media popularity ,पीएम मोदी की लोकप्रियता में इजाफा ,33,34,-1
6277,Enduring Memories ,यादें अटल की ,18,13,5
6283,Chauvinism takes many forms: ,संकीर्ण मानसिकता के अनेक रूप हैं: ,29,34,-5
6289,Who r the culprits? ,कौन अपराधी हैं? ,20,16,4
6300,"PS- SHAMBHUGANJ, DIS- BANKA ","पीएस- शंभुगंज, डीआईएस- बंका ",28,28,0
6303,What to take care of ,किन बातों का ख्याल रखें ,21,24,-3
6305,genus Lotus ,इंदंबर ,12,7,5
6310,Clovers can have more than four leaves. ,पॉलिप्लॉइड में चार से अधिक कुलक भी हो सकते हैं। ,40,48,-8
6311,His life story is unbelievable. ,उनकी जिंदगी की कहानी अविश्वसनीय है। ,32,36,-4
6316,Education of women is encouraged. ,महिलाओं में शिक्षा को बढ़ावा देना है. ,34,38,-4
6325,"Yet, the issue fails to be resolved. ",बावजूद इस समस्या का समाधान नहीं हो पा रहा है। ,37,46,-9
6333,"""The high court acquitted all the accused. ",हाईकोर्ट ने सभी आरोपियों को रिहा कर दिया था। ,43,45,-2
6335,If you want purchase this smartphone? ,क्या आपको ये स्मार्टफोन खरीदना चाहिए? ,38,38,0
6336,We are men. We're going to mess up. ,हम पुरुष हैं। हम गड़बड़ तो करेंगे। ,36,35,1
6346,You Must Not Forget Jehovah ,यहोवा को कभी मत भूलिए ,28,22,6
6347,This is her first visit to India. ,यह उसका भारत में पहला सम्मेलन है। ,34,34,0
6353,lese majesty ,देशद्रोह ,13,9,4
6355,But that strategy has its limits. ,लेकिन इस रणनीति की भी अपनी सीमा है। ,34,36,-2
6362,I opened the door. ,मैंने दरवाज़ा खोला। ,19,20,-1
6364,He is truly among Our faithful devotees. ,बेशक वह हमारे (ख़ालिस) ईमानदार बन्दों में थे ,41,45,-4
6366,No action taken ,नहीं लिया गया कोई एक्शन ,16,24,-8
6370,She is paired with Sidharth Malhotra in the film. ,फिल्म में उनके साथ सिद्धार्थ मल्होत्रा भी हैं। ,50,47,3
6372,Each bus will accommodate at least 60 passengers. ,प्रत्येक दल में अधिकतम 60 यात्री होंगे। ,50,40,10
6373,I remembered that one of my aunts was a Witness. ,मैंने उससे पूछा कि यह कौन - सा चर्च है । ,49,41,8
6382,Upanishads- lie in these 4 parts. ,उपनिषद् इन चार भागों में है। ,34,29,5
6383,"""The areas of economic cooperation are: - ",आर्थिक सहयोग के क्षेत्र इस प्रकार हैं:- ,42,40,2
6385,"""The police was investigating. ",पुलिस तफ्तीश कर रही है। ,31,24,7
6388,Symptoms that may be present include: ,सामान्यतः दिखाई देने वाले लक्षण निम्नलिखित हैंः ,38,48,-10
6390,He urged all to contribute their best for this. ,उन्होंने कहा कि इसमें सभी लोग अपना सहयोग दें। ,48,46,2
6392,Yes and no. ,नहीं । ,12,7,5
6399,Happy Fathers Day to all. ,हैप्पी फादर्स डे आप सभी को डैडी। ,26,33,-7
6400,It can be a matter of debate. ,यह एक बहस का विषय हो सकता है। ,30,30,0
6410,"""They should get relief. ",उन्हें राहत मिलनी चाहिए। ,25,25,0
6412,100 per cent results ,परिणाम 100 प्रतिशत है। ,21,23,-2
6417,Congress comes under attack ,कांग्रेस हुई हमलावर ,28,20,8
6433,China has already progressed some way on this. ,इस दिशा में चीन ने उत्तरोतर कदम बढ़ाए हैं। ,47,43,4
6452,FREQUENCY (Range data. Range bins) ,FREQUENCY (सीमा डाटा. सीमा बिन्स) ,35,34,1
6454,Driver killed as tractor crashes into tent ,"ट्रक ने ट्रैक्टर टेलर में मारी ठोकर, चालक की मौत ",43,49,-6
6455,He seems to be in touch with extremists. ,"""वह अतिवदी लोगों के सम्पर्क में लगता है। ",41,41,0
6466,"""The two become friends. ","""वह दोनों दोस्त बन जाते हैं। ",25,29,-4
6467,Additional police forces have been deployed. ,अतिरिक्त सैन्य बल तैनात किए जा चुके हैं। ,45,41,4
6476,But we will always be good parents. ,लेकिन हम हमेशा अच्छे माता पिता रहेंगे. ,36,39,-3
6479,Squads of India and Australia ,भारत और ऑस्ट्रेलिया की टीमें ,30,29,1
6481,Show items that contain: ,मद दिखाएँ जो शामिल हैः (w) ,25,27,-2
6482,It completely worked. ,यह पूरी तरह काम कर गया। ,22,24,-2
6491,Do read it. ,वो आप पढ़िए. ,12,12,0
6494,"""The first match will be played in Mumbai. ",सीरीज का पहला मैच मुंबई में खेला जायेगा। ,43,41,2
6498,I am ready to sacrifice anything for it. ,मैं किसी भी तरह के बलिदान के लिए तैयार हूं। ,41,44,-3
6505,26-year-old hangs himself to death ,34 वर्षीय युवक की ईंट मारकर ली जान ,35,35,0
6507,Dont take social media so seriously ,'सोशल मीडिया को गंभीरता से लेने का मतलब नहीं' ,36,46,-10
6512,"""The writer is a columnist. ",लेखक स्तंभकार हैं। ,28,19,9
6517,"""The man shouted for all to hear. ","""वह आदमी सबको सुनाने के लिए चिल्लाया । ",34,39,-5
6527,Lessons from the Chennai floods ,चेन्नई की बाढ़ से सबक लेना जरूरी ,32,33,-1
6528,In the words of the great Howard Jones... ,महान हावर्ड जोन्स के शब्दों में... ,42,35,7
6531,Access time ,अभिगम समय/अवधि ,12,15,-3
6532,He then got up and left the room. ,फिर उठकर भीतर कक्ष में चले गए। ,34,31,3
6533,An FIR has been filed against seven persons. ,सात लोगों के खिलाफ एफआईआर दर्ज की गई है। ,45,41,4
6534,How is it different this time? ,इस समय स्थिति कैसे अलग है? ,31,27,4
6535,Outside of home ,घर से बाहर ,16,11,5
6545,"so let it be there, first thing. ","अतः इसे रहने दो, पहली बात। ",33,27,6
6546,This is putrid corruption. ,ये इंतिहा है भ्रष्टाचार की। ,27,28,-1
6548,Fit India. ,फिट इंडिया ” ,11,13,-2
6555,Greek Dark Ages ,यूनानी अंधकार काल ,16,18,-2
6556,We are waiting for more details. ,हम और विवरण का इंतजार कर रहे हैं। ,33,34,-1
6582,"""The villagers informed the police ",ग्रामीणों ने पुलिस को सूचना देने के . ,35,38,-3
6597,This is my wish. ,ये मेरी मर्जी है. ,17,18,-1
6601,For now. ,अभी के लिए -. ,9,14,-5
6602,"""There are two kinds of waste. ",कचरा दो प्रकार का होता है। ,31,27,4
6610,I dont know why they remained silent. ,पर पता नहीं क्यों वो भी चुप हैं…. ,38,34,4
6611,He later became a legislator. ,इसके बाद विधायक भी बने. ,30,24,6
6616,Let the facts speak for themselves. ,पिछले दस सालों की ही बात लीजिए । ,36,33,3
6621,"Sultanpur Lodhi, September 3 ","सोनीपत, 3 सितंबर (हप्र) ",29,24,5
6622,I dont have the time. ,समय भी नहीं है मेरे पास. ,22,25,-3
6625,But the problem has not been solved. ,लेकिन समस्या का समाधान नहीं किया गया है। ,37,41,-4
6626,Financial Times printed this picture ,"फ़िनान्शियल टाइम्स ने इस तस्वीर को छापा था, ",37,44,-7
6638,Many of them fled. ,उनमें से कई फरार हैं. ,19,22,-3
6642,Students should work hard. ,छात्रों को मेहनत करनी होगी. ,27,28,-1
6643,I am pretty certain. ,मैं काफी संतुष्ट हूं। ,21,22,-1
6646,How do you see this action? ,इस जर्नी को कैसे देखती हैं? ,28,28,0
6648,This investigation is ongoing. ,इसके लिए छापेमारी की जा रही है। ,31,32,-1
6651,"I would say to myself, ","मैं खुद से पूछने लगता हूँ, ",23,27,-4
6653,Her oxygen saturation level was low. ,ऑक्सीजन सैचूरेशन लेवल काफी कम था. ,37,34,3
6654,Responsibility of teachers ,शिक्षक की जिम्मेदारी ,27,21,6
6657,After all who is to be blamed for this ? ,आखिर इस सबके लिए किसे ज़िम्मेदार माना जाए? ,41,43,-2
6661,"If its war that is required, then so be it. ",अगर इसके लिए युद्ध की जरूरत है तो वही सही। ,44,43,1
6663,Excellent remedy for cough and cold. ,सर्दी-जुकाम और कफ के लिए भाप रामबाण उपाय है। ,37,45,-8
6669,So how has Delhi fared? ,फिर दिल्ली कैसे बची रहती. ,24,26,-2
6676,"Last year, the number was at 9.27 lakh. ",पिछले साल यह संख्या 9.27 लाख थी। ,40,33,7
6677,"""They should be paying attention. ",उन्हें सावधानी बरतनी होगी। ,34,27,7
6680,"""The girl died in the incident. ",घटना में बच्ची की मौत हो गई थी. ,32,32,0
6681,He has no experience. ,कोई अनुभव नहीं था. ,22,19,3
6683,later on he joined the Samajwadi Party (SP). ,बाद में वे समाजवादी पार्टी में शामिल हो गये. ,45,45,0
6684,"1 small onion, finely chopped ","1 छोटा आलू, बारीक कटा हुआ ",30,26,4
6691,Tom broke both of his legs. ,टॉम ने उसकी दोनों टांगे तोड़ दी। ,28,33,-5
6692,Apply on the face and wash after it dries. ,इसे चेहरे पर लगाएं और सूखने के बाद धो लें। ,43,43,0
6694,"We are all one, in that sense. ",एक तरह से हम एक ही हैं। ,31,24,7
6698,He spoke to me very nicely. ,उसने मुझसे बहुत प्यार से बात की। ,28,33,-5
6701,"""The writer is director, My Financial Advisor ",लेखक माई फाइनैंशियल एडवाइजर के निदेशक हैं। ,46,43,3
6717,Valentines Day is gearing near. ,वेलेंटाइन डे करीब आ गया है। ,32,28,4
6719,This is just the start. ,यह तो अभी शुरुआत है। ,24,21,3
6721,adjudication of notes ,नोटों का न्यायनिर्णयन ,22,22,0
6725,Gods Love Manifest in a Mothers Love ,परमेश्‍वर का प्यार माँ के प्यार से झलकता है ,37,44,-7
6731,listening to all... ,सब की बात सुने. ,20,16,4
6734,"Mandi Ahmedgarh, Nov 8 ","महेन्द्रगढ़, 8 नवंबर (निस) ",23,26,-3
6735,Consequently problems were faced. ,जिससे समस्याओं का सामना करना पड़े। ,34,35,-1
6741,Anything happened to any of them? ,क्या उनमें से किसी में कुछ निकला? ,34,34,0
6743,"""The HC had also initiated a CBI inquiry. ",कोर्ट ने सीबीआई की भी खिंचाई की। ,42,33,9
6744,Compilation of Bachan's great poetry . ,बच्चन के श्रेष्ठ कविताओं का संकलऩ ,39,34,5
6752,This was Simon's second marriage. ,मिलिंद सोमन की यह दूसरी शादी है। ,34,33,1
6755,All photos by author ,सभी फोटो: लेखक ,21,15,6
6759,"""The Manisana Wage Board ",मनिसाना वेज बोर्ड ,25,18,7
6761,Try and avoid alcohol and smoking. ,कोशिश करें कि स्मोकिंग और शराब न पीएं। ,35,39,-4
6770,Fans are stunned looking at it. ,ये देख कर फैंस में मायूसी छा गई हैं। ,32,37,-5
6775,"Last date to apply: February 11, 2020 ","फीस भरने की अंतिम तिथि : 19 नवंबर, 2020 ",38,40,-2
6777,"""There was never a disagreement between the two. ",दोनों के बीच मनमुटाव वाली कोई बात नहीं थी। ,49,43,6
6784,Priyanka Chopra was the female lead in the movie. ,इस फिल्म में कंगना के अपोजिट प्रियंका चोपड़ा थीं। ,50,50,0
6788,But still they have not been released. ,हालांकि उन्‍हें अभी बाहर नहीं किया गया है. ,39,43,-4
6796,"""The total amount is close to Rs 200 crore. ",उसके लिए कुल आबंटन लगभग 250 करोड़ रुपये ही है। ,44,47,-3
6815,Its rather odd but true. ,"थोड़ा अजीब है, लेकिन सच है। ",25,28,-3
6818,Its the greatest prize. ,यह सबसे बड़ा सरप्राइज है। ,24,26,-2
6833,I went into the restaurant. ,मैं रेस्टोरेंट की ओर भागा। ,28,27,1
6835,"After that, the case has taken new turn. ",इसके बाद इस मामले ने यू टर्न ले लिया. ,41,38,3
6841,Where in Austria did you grow up? ,ऑस्ट्रिया में तुम कहां बड़े हुए? ,34,33,1
6843,Hinduism is not a static religion. ,हिन्दुत्व कोई अनुशासित धर्म नहीं है। ,35,37,-2
6857,He pointed his finger to the head. ,उन्होंने सिर पर हाथ फेरा। ,35,26,9
6862,2000 crore shelf limit. ,होगी 2000 रुपये की लिमिट ,24,25,-1
6868,He acted very brilliantly in this film. ,इस फिल्म में इन्होंने दमदार अभिनय किया था! ,40,43,-3
6871,Married life will be pleasant. ,वैवाहिक जीवन सुखकर होगा। ,31,25,6
6872,Ex- Salem: 6 days a week (Except Sun) ,करूर - सलेम डेमू (सप्ताह में 6 दिन) ,38,36,2
6876,"This time, she is the main character. ",निःसन्देह यह प्रमुख विशेषता है। ,38,32,6
6877,This has left students worried. ,इससे अभ्यर्थियों की चिंता बढ़ गई है। ,32,37,-5
6881,Brief history of India After freedom. ,स्वतन्त्रता के बाद भारत का संक्षिप्त इतिहास ,38,44,-6
6883,Know the whole story ,जानते हैं पूरी कहानी- ,21,22,-1
6888,How can this be accepted. ,इसे कैसे स्वीकार किया जा सकता है. ,26,34,-8
6889,"Police, however, is investigating the matter. ",वैसे पुलिस मुद्दे की जाँच में जुटी है. ,46,39,7
6893,"""The two day event will conclude on Monday. ",दो दिवसीय शिविर का समापन रविवार को होगा। ,44,41,3
6894,"On this day, Goddess Brahmacharini is worshipped. ",इस दिन मां ब्रह्मचारिणी की भी पूजा की जाती है। ,50,47,3
6896,But that wasnt enough to compensate. ,लेकिन यह हार टालने के लिए काफी नहीं था। ,37,40,-3
6897,Looking For Big Mutt 8. ,वें बिग बॉस 8 की प्रतिभागी हैं। ,24,32,-8
6898,development and prosperity. ,विकास का और खुशहाली का. ,28,24,4
6901,Many have been arrested. ,कई में गिरफ्तारी भी हुई है। ,25,28,-3
6906,But the BJP was having none of it. ,लेकिन भाजपा इसके लिए तैयार नहीं थी. ,35,36,-1
6907,I've thought a lot about it. ,मैं ने इसके बारे में बहुत सोचा था | ,29,36,-7
6908,This will strengthen your bones. ,इससे पैरों के अंदर वाली साइड्स मजबूत होगी। ,33,43,-10
6910,On - Screen Creature ,ऑन स्क्रीन कैप्चर ,21,18,3
6918,"Ever since then, they have been ",तब से लेकर उनके संन . ,32,22,10
6928,"Post & Thana Lawan, Tahsil & Distt ","पोस्ट और थाना लॉन, तहसील और जिला ",35,33,2
6930,"""They had a heated argument over the issue. ",इसी मुद्दे पर भारी गहमा-गहमी हो गई। ,44,36,8
6931,Passengers shall observe social distancing. ,यात्रीगण सामाजिक दूरी का पालन करेंगे। ,44,38,6
6933,But its a good lesson for us. ,लेकिन हमारे लिए यह अच्छा सबक है। ,30,33,-3
6937,So here the processes on board ,तो यहाँ बोर्ड प्रोसेसर ,31,23,8
6941,He had even given up once. ,एक बार इस्तीफ़ा भी दे दिया था. ,27,30,-3
6951,Supplies have already started ,इनका आपूर्ति पहले ही शुरू हो चुकी है ,30,37,-7
6955,He announced this via a post on Twitter. ,ये जानकारी उन्होंने ट्विटर पर दी। ,41,34,7
6960,We have begun work on this project. ,हमने उस परियोजना पर काम करना शुरू कर दिया है। ,36,46,-10
6962,Prime Minister Narendra Modi | Photo: PTI ,प्रधानमंत्री नरेंद्र मोदी | फोटो : दिप्रिंट ,42,44,-2
6964,Thus he believed and thus he sought. ,यही वे मानते और इसी की खोज करते थे। ,37,36,1
6967,A fourth person died later in hospital. ,बाद में चौथे ने भी अस्पताल में दम तोड़ दिया। ,40,45,-5
6992,"""The conference began with lighting of the lamp. ",सम्मेलन का शुभारंभ दीप प्रज्जवलित कर किया गया। ,49,47,2
6995,"Be their hero, Clark. ","उनके नायक, क्लार्क बनें। ",22,25,-3
7003,Dont have this habit. ,इसे आदत न बनाएं। ,22,17,5
7004,Wash your hair with warm water. ,हल्के गुनगुने पानी में ही बालों को धुले। ,32,41,-9
7010,"those are they brought nigh the Throne, ",यही लोग (ख़ुदा के) मुक़र्रिब हैं ,40,31,9
7013,This case is also pending in the court. ,यह मामला भी अभी अदालत में विचाराधीन है। ,40,40,0
7014,Revive your sex life ,सेक्स लाइफ को ऐसे करें इंज्यॉय ,21,31,-10
7019,Show Details ,विवरण दिखाएँ ,13,13,0
7021,A complaint has been filed at the police station. ,थाना में दर्ज रिपोर्ट में आरोप लगाया गया है। ,50,45,5
7023,2006 was a great year. 2006 ,का साल बहुत अच्छा बीता. ,28,24,4
7031,"Who taught by the pen, ",जिसने क़लम के ज़रिए तालीम दी ,23,29,-6
7032,"He died at the age of 74 on May 27, 1964. ","उन्होंने 27 मई, 1964 को अंतिम सांस ली। ",42,39,3
7037,We dont want to wage war with Pakistan. ,मैं पाकिस्तान के साथ युद्घ नहीं चाहता। ,40,39,1
7039,"Harbhajan Singh, Mohhamed Kaif on BB13 ",BB 13 में पहुंचे हरभजन सिंह-मोहम्मद कैफ ,39,40,-1
7040,Former South Africa batsman AB de Villiers. ,दक्षिण अफ्रीका के बल्लेबाज एबी डिविलियर्स। ,44,43,1
7041,Meanwhile police is investigating the case. ,"""वहीं पुलिस इस मामले की तफ्तीश मे जुट गई है। ",44,45,-1
7042,Four injured as truck overturns ,ट्रैक्टर की चपेट में सूमो सवार चार घायल ,32,40,-8
7044,"""They enjoy so many blessings! ",वे कितनी सारी आशिषों का आनन्द उठाते हैं! ,31,41,-10
7045,U/S 145 ,यू / एस 145 ,8,12,-4
7046,You will go to dinner with your spouse. ,जीवनसाथी के साथ डिनर करने जाएंगे । ,40,35,5
7051,What is it? ,कौन - सा सवाल? ,12,15,-3
7054,Who do you think he is? ,तुम्हारे ख़याल से वह कौन है? ,24,29,-5
7057,where had you disappeared to? ,बीच में आप कहां गायब हो गए थे? ,30,31,-1
7059,"""The two perform together. ",दोनों साथ में डांस कर रहे हैं। ,27,31,-4
7061,Farm Sector Policy Department ,कृषि क्षेत्र नीति विभाग ,30,24,6
7068,But this argument is wrong. ,पर यह तर्क सही नहीं है। ,28,24,4
7074,But all got was disappointment. ,लेकिन सबको निराशा ही हाथ लगी। ,32,30,2
7081,And noise there was. ,और वहां अफरातफरी मच गई। ,21,24,-3
7085,You will implement your plans. ,योजनाओं को फलीभूत करेंगे. ,31,26,5
7087,covering it with what covered it. ,(फिर उन पर) जो छाया सो छाया ,34,28,6
7089,Salskar challenged this verdict in Supreme Court. ,उस फैसले को सलमान ने हाईकोर्ट में चुनौती दी। ,50,45,5
7090,Arvind Kejriwal (PTI photo) ,अरविंद केजरीवाल (फाइल फोटो-PTI) ,28,32,-4
7094,People are angry with Pakistan. ,लोगों में पाकिस्तान के खिलाफ गुस्सा है। ,32,40,-8
7095,Where is the Left and the Congress? ,कहां है विपक्ष और कांग्रेस…? ,36,29,7
7099,But dont fight it. ,लेकिन आपको लड़ना नहीं है। ,19,26,-7
7101,Ease of approaching consumer commission ,उपभोक्ता आयोग से संपर्क करने में आसानी ,40,39,1
7103,"""Then why are these people scared? ",तो फिर यह लोग क्यों डर रहे हैं? ,35,32,3
7113,What do we listen to? ,हम किसकी बात सुनते हैं. ,22,24,-2
7118,"""The incident was caught on a CCTV camera. ",यह घटना वहां लगे एक CCTV कैमरे में कैप्चर हो गई। ,43,49,-6
7119,At first glance this prophecy may seem cryptic. ,पहली नज़र में तो यह भविष्यवाणी शायद रहस्यमय लगे । ,48,50,-2
7129,"However, there's also another side to it. ","हालांकि, इसका एक पहलू और भी है। ",42,32,10
7134,"""They are improving. ",वे सुधर भी रहे हैं। ,21,20,1
7147,Low level of education of girls ,लड़कियों की शिक्षा का निचला स्तर ,32,33,-1
7150,India in reply could manage only 221 runs. ,जवाब में केकेआर 9 विकेट पर 112 रन ही बना सकी। ,43,46,-3
7151,Stats & Analysis ,डाटा और एनालिटिक्स ,17,19,-2
7161,But that also didnt work. ,लेकिन यह भी काम नहीं किया। ,26,27,-1
7167,"UT sells onions amid security, at Rs 32 a kg ",विभाग ने 31 रुपये प्रति किलो बेचा प्याज ,45,40,5
7170,"No, indeed, surely, this is a Reminder. ",हाँ हाँ बेशक ये (क़ुरान सरा सर) नसीहत है ,40,41,-1
7172,Women in panchayats ,पंचायतों में महिलाएं ,20,21,-1
7180,"not this, not that either ",ना इसकी-ना उसकी। ,26,17,9
7188,"""They also assaulted her two daughters. ",दोनों लड़कियों ने भी उन पर हमला किया। ,40,38,2
7190,A months deadline has been set for this. ,इसके लिए एक महीने का समय निर्धारित है। ,41,39,2
7191,Elizabeth then became queen. ,इसके साथ एलिजाबेथ महारानी बन गयी। ,29,34,-5
7195,File Photo of Donald Trump ,डोनॉल्ड ट्रंप की फाइल फोटो ,27,27,0
7206,"""The shooting of the film has begun. ",फिल्म की शूटिंग की शुरूआत गाने से हुई है। ,37,42,-5
7208,"""There was a dispute between two parties. ",दोनों पक्षों में विवाद होने लगा। ,42,33,9
7215,Retrieved on 5 January 2019. ,5 जनवरी 2019 को लिया गया। ,29,26,3
7218,We are receiving reports within 10 days. ,डिपॉजिट्स पर हमें रोज रिपोर्ट्स मिल रही हैं। ,41,45,-4
7238,"""There is no violence. ",हिंसा की कोई बात नहीं है. ,23,26,-3
7240,It cannot be permitted. ,इसकी अनुमति नहीं दी जा सकती. ,24,29,-5
7249,Vesical Colic are also called as venae vesicales. ,मूत्राशयशूल को वेनी वेसाइकालेस भी कहा जाता है. ,50,47,3
7253,At least 15 people died in the incident. ,इस घटना में 15 लोगों की मौत हो गई थी. ,41,38,3
7256,Thats the way I play. ,मैं ऐसे ही खेलता हूं. ,22,22,0
7274,No run on the last ball. ,आखिरी गेंद पर तो बिल्कुल भी नहीं. ,25,34,-9
7277,Big day for India. ,भारत के लिए एक बड़ा दिन। ,19,25,-6
7283,Windows Printer via SAMBA ,SAMBA के द्वारा विंडो प्रिंटर ,26,30,-4
7284,"""The film was helmed by Siddharth Anand. ",इस फ़िल्म का निर्देशन सुरेंदर रेड्डी ने किया है। ,41,49,-8
7285,"Because, we dont have money for. ",क्योंकि हमारे पास पैसा नहीं है। ,33,32,1
7292,Money is like water ,पैसा पानी की तरह बहाइए। ,20,24,-4
7308,"""""""This is not how democracy runs."" ","मोदी ने कहा, ‘लोकतंत्र इस तरह से नहीं चलता. ",36,44,-8
7317,So is it true? ,क्या वाकई ऐसा है? ,15,18,-3
7325,Police took the girl... ,पुलिस ने बालिका . पढ़े ,24,22,2
7326,Together we can overcome this crisis! ,हम साथ मिलकर इस इस संकट को हरा देंगे. ,38,38,0
7329,Law abiding citizens have rights too. ,वर्दी वाले को भी नागरिक अधिकार प्राप्त हैं। ,38,44,-6
7331,"""But they did not get"""" there."" ",लेकिन उन्हें वहां भी राहत नहीं मिली. ,32,37,-5
7333,This has adversely impacted the economy. ,जिसका अर्थव्यवस्था पर बुरा प्रभाव पड़ा है। ,41,43,-2
7338,It has been launched in Black and Blue colours. ,इसे काले और नीले रंग में उतारा गया है. ,48,39,9
7339,Eight infants die in Pakistani hospital ,पाकिस्तान के अस्पताल में आठ शिशुओं की मौत ,40,42,-2
7341,Electricity charges have been hiked. ,बिजली के दाम बढ़ा दिए गए हैं। ,37,30,7
7344,North Korean films in Berlin ,बर्लिन में फिल्म के सितारे ,29,27,2
7346,superscript 5 ,सुपरस्क्रिप्ट 5 ,14,16,-2
7350,to subject children to pain ,"कि बच्चों को पात्र बनाया जाए वेदना, ",28,36,-8
7356,"No, why? ",क्यों नहीं? ,9,12,-3
7357,small and medium enterprise ,लघु और मध्यम उद्यम ,28,19,9
7374,Later the entire money was deposited. ,फिर पूरा पैसा ट्रांसफर कर लिया करता था। ,38,40,-2
7375,open competitive test ,खुली प्रतियोगिता परीक्षा ,22,25,-3
7383,Proteins are essential for a childs growth. ,शिशु के विकास के लिए प्रोटीन बहुत जरूरी तत्व है। ,44,49,-5
7392,This should not be surprising. ,यह हैरानी की बात नहीं होनी चाहिए । ,31,35,-4
7394,Rainfall predicted in seven states ,इन राज्यों में हो रही जमकर बारिश ,35,33,2
7396,We should ponder on these questions. ,इस सवाल पर विचार होना चाहिए। ,37,29,8
7399,I will decide. ,मैं इसका फैसला करूंगा। ,15,23,-8
7409,Our state is a peaceful state. ,"उन्होंने कहा, ‘हमारा देश शांतिपूर्ण है। ",31,40,-9
7417,But he wasnt done just yet. ,लेकिन वह अभी तक नहीं डाली गई। ,28,30,-2
7420,"So, to the extent that evolution doesn 't matter, ","तो, उस मामले में विकास से कोई फ़र्क नहीं पड़ता, ",50,48,2
7425,We all have different strengths. ,हम सब में अलग क्षमता है. ,33,25,8
7428,Output is down by around 40 per cent. ,करीब 40 फीसदी रिजल्‍ट लटका है। ,38,31,7
7434,"""The governments by ",पूर्वर्ती सरकारों ने . ,20,23,-3
7435,But we know that we dont. ,लेकिन हम जानते हैं कि ऐसा नहीं है. ,26,35,-9
7441,Rahul was no interested. ,राहुल को इससे कुछ भी मतलब नहीं था। ,25,35,-10
7452,and are oblivious of the Hereafter. ,और आख़ेरत को छोड़े बैठे हो ,36,27,9
7457,I laughed at the proposal. ,मैं इस प्रस्ताव पर हंसा. ,27,25,2
7460,It is not just manufacturing. ,सिर्फ उत्पादन करने से ही नहीं होगा। ,30,36,-6
7468,"Section - 23, Wealth-Tax Act, 1957 ","धारा - 23, संपत्ति कर अधिनियम, 1957 ",35,36,-1
7476,"""The second replied. ",दूसरी का जवाब था। ,21,18,3
7479,Fiction: Everything else I read about me today. ,कल्पना: हर वो बात जो आज मैं अपने बारे में पढूंगी। ,48,50,-2
7480,"""They work on two levels. ",वे दो शिफ्ट में काम करते हैं। ,26,30,-4
7482,Officers will be pleased with your work. ,आपके काम से अधिकारी खुश होंगे। ,41,31,10
7500,"""The students should not worry. ",इसमें छात्रों को न घसीटा जाए। ,32,30,2
7501,Many of his supporters have joined the BJP. ,इनमें से कई भाजपा में शामिल हुए हैं. ,44,37,7
7502,Which is witnessed by the close ones. ,उसके पास मुक़र्रिब (फ़रिश्ते) हाज़िर हैं ,38,41,-3
7506,She is the producer in the film. ,"""वह इस फिल्म के सह-निर्माता हैं। ",33,33,0
7513,Men are wicked. ,आदमी बहुत खतरनाक है। ,16,21,-5
7527,"""Then why are we talking about it here? ",फिर हमारे यहां क्यों हो जाता है। ,40,33,7
7532,Drink at least 2 litres of water every day ,दिन में कम से कम 2 लीटर पानी पिएं। ,43,35,8
7539,An order detailing the amount of assessment. ,कर निर्धारण के विवरण देने वाला आदेश। ,45,37,8
7546,Deepak wins gold ,दीपक ने जीता गोल्ड ,17,19,-2
7549,"""The exports for -2 have grown by 13.4. ",दूसरी तिमाही में निर्यात 13.4 प्रतिशत बढ़ा है। ,40,47,-7
7556,A proposal in this connection is being prepared. ,इसके लिए प्रस्ताव तैयार कर लिया गया है। ,49,40,9
7561,No rent ,किराया नहीं। ,8,13,-5
7563,Similarities with Dhoni ,धोनी से हो रही तुलना ,24,21,3
7566,"However, soon this changed. ","बहरहाल, जल्द ही यह सब बदलने लगा। ",28,33,-5
7577,A bad relationship isnt me too. ,एक बुरा रिश्ता मी टू नहीं होता। ,32,32,0
7583,India has a different climate from England. ,भारत का मौसम इंग्लैड के मौसम से एकसमान नहीं है। ,44,48,-4
7591,It comes with 182 mm ground clearance. ,"""वहीं, इसका ग्राउंड क्लियरेंस 182 मिलीमीटर है. ",39,47,-8
7595,will be carried out. ,से की जाएगी। ,21,13,8
7601,"Price : Rs 13,498 ","कीमत : 5,377 रुपये\\xa0 ",18,24,-6
7609,Deleting group '% 1' failed. ,समूह '% 1' मिटाने में असफल. ,29,28,1
7611,Compose Layer plugin ,कंपोज लेयर प्लगइनName ,21,22,-1
7619,"Hence, a huge accident was averted. ",इस कारण बड़ी दुर्घटना टल गई। ,36,29,7
7629,"""They will have no food except cactus, ",ख़ारदार झाड़ी के सिवा उनके लिए कोई खाना नहीं ,39,45,-6
7634,"""The injured were sent to hospital. ",घायलों को अस्पताल में भेज दिया। ,36,32,4
7640,"After assurance, the strike was called off. ",इसमें आश्वासन देने के बाद चक्काजाम खत्म किया गया। ,44,50,-6
7641,A search is underway on to nab him. ,उसकी गिरफ्तारी के लिए छापेमारी की जा रही है। ,36,45,-9
7647,tied loans ,सशर्त ऋण ,11,9,2
7648,Ankita Bhargava with Karan Patel ,करण पटेल के साथ अंकिता भार्गव। ,33,31,2
7649,A sliding - block puzzle game ,एक फिसलते हुवे चौरसी उलझन का खेल ,30,33,-3
7652,People get angry. ,लोग शर्द्धांजलि देते हैं. ,18,26,-8
7656,Read on to know the full report... ,पूरा वाकया जानने के लिए पढ़ें यह रिपोर्ट . ,35,43,-8
7660,I am also serious about it. ,मैं उसको लेकर गंभीर भी हूं. ,28,28,0
7664,"""""""Is this Gandhi's India or Godse's India?"""""" ","यह गोडसे का भारत है, या गांधी का भारत है। ",47,42,5
7675,"Indeed, they were not. ",मूलत: वे वैसे नहीं थे। ,23,23,0
7681,(with inputs from agency) ,' (साथ में एजेंसी से भी इनपुट) ,26,31,-5
7683,Technology sometimes does get commoditized. ,हाइटेक होती तकनीक कभी-कभी अभिशाप बन जाती है। ,44,45,-1
7691,That too is an obfuscation. ,यह भी एक भ्रम है। ,28,18,10
7694,Change string: ,रूप विन्यास बदलें ,15,18,-3
7698,"""There are a few strange stories. ","""वहां अजीब सी घटनाएं हो रही हैं. ",34,33,1
7699,what is a lockdown? ,लॉकडाउन क्या होता है? ,20,22,-2
7703,in the media. ,अन्य मिडिया में. ,14,17,-3
7718,But he was not a free man. ,लेकिन वह अब भी आजाद नहीं थे. ,27,29,-2
7726,Nobody tells me anything. ,कोई मुझे कुछ भी नहीं बता रहा है. ,26,33,-7
7729,Trump is doing what he wants. ,ट्रम्प की सोच है कि जो मर्जी आए वह करो। ,30,40,-10
7731,"""The matter was informed to the police. ",मामले की सूचना पुलिस को दी गई. ,40,31,9
7733,A lot of money. ,बड़ी मात्रा में धनराशि। ,16,24,-8
7734,take stock ,टेस्ट करना ,11,11,0
7736,Abolished compulsory military training. ,अनिवार्य सैनिक सेवा पर प्रतिबंध लगा दिया गया। ,40,46,-6
7743,"In fact, they live in a 12 - dimensional space. ","वास्तव में, वे एक १२-आयामी अंतरिक्ष में रहते हैं। ",48,50,-2
7748,Police couldnt find him so far. ,जिसका अभी तक पुलिस कोई पता नहीं लगा सकी। ,32,41,-9
7753,"However, his condition is said to be stable. ",हालांकि उसके दोस्त की हालत स्थिर बताई जा रही है. ,45,49,-4
7759,Three other persons were injured in the mishap. ,इस हादसे में तीन अन्‍य लोग घायल हो गए थे. ,48,42,6
7760,But medicines did not help. ,लेकिन दवा नहीं मिली। ,28,21,7
7762,We are still developing steadily. ,हम लगातार आगे बढ़ रहे हैं. ,34,26,8
7763,She leaped for joy. ,"""वह खुशी से उछल पड़ी। ",20,22,-2
7766,How to benefit ,कैसे पहुंचाती है फायदा ,15,23,-8
7769,That did not explain the mystery. ,रहस्य तो रहस्य ही बना रहा। ,34,27,7
7778,Do n 't wear slippers all day. ,सारा दिन स्लिपरों को न पहनें. ,31,30,1
7781,This warning needs to be paid heed to. ,इस चेतावनी को नज़रअंदाज नहीं किया जाना चाहिए। ,39,46,-7
7783,"""The aim is to double farmers income by 2022. ",2022 तक किसानों की आय दोगुनी करने का लक्ष्य। ,46,45,1
7794,We must make efforts to eradicate it. ,हमें इसे दूर करने के लिए कड़ी मशक्कत करनी होगी। ,38,48,-10
7799,Doesnt that discomfort them? ,क्या इससे उन्हें असुविधा नहीं होती है? ,29,39,-10
7804,Who is responsible for this? ,सवाल यह है कि इसके लिए दोषी कौन है। ,29,36,-7
7820,Agra on Wikimapia ,विकिमैपिया पर आगरा ,18,19,-1
7823,Miller also won the Man of the Match title. ,मिलर ने मैन ऑफ द मैच का खिताब भी जीता। ,44,39,5
7827,"""The police were searching him for many days. ",आपको बता दें कि कई दिनों पुलिस को उनकी तलाश थी। ,46,48,-2
7831,Rescue operation is currently underway. ,फिलहाल अभी तक रेस्क्यू ऑपरेशन चल रहा है। ,40,41,-1
7835,"""There was a huge crowd of villagers. ",बड़ी संख्या में ग्रामीणों की भीड़ जुटी रही। ,38,42,-4
7852,This app is not open to public. ,यह ऐप अभी पब्लिक के लिये उपलब्ध नहीं है। ,32,41,-9
7857,But no government official is bothered about it. ,लेकिन किसी भी अधिकारी का ध्यान इस और नहीं है। ,49,46,3
7859,She writes regularly for various publications. ,सम्प्रति विभिन्न पत्र-पत्रिकाओं के लिए लेखन। ,47,45,2
7860,Dont make a big deal out of it. ,इसे बड़ा मुद्दा न बनाओ। ,32,24,8
7863,He says there is threat to his life. ,उनका कहना है कि उन्हें जान का खतरा है। ,37,39,-2
7870,Aquarius: Business will increase. ,मेष: व्यावसायिक व्यस्तता बढ़ेगी। ,34,33,1
7874,More important. ,से ज्यादा जरूरी है। ,16,20,-4
7877,All parties have agreed to this. ,इस बात पर सभी दलों में सहमति है। ,33,33,0
7879,A variant of regurgitate. ,बहने का एक प्रकार. ,26,19,7
7880,Thats also quite interesting. ,इसे काफी रोचक भी बनाया गया है. ,30,31,-1
7888,It is a lesson for all. ,सबको यह सिखलाती गुल्लक। ,24,24,0
7893,"""The post was later deleted. ",बाद में उन पोस्ट को हटा लिया गया था। ,29,37,-8
7911,I doubt it. ,नहीं तो . ,12,10,2
7924,dont strike ,टोकें नहीं ,12,11,1
7925,Violence never wins. ,हिंसा की कभी जीत नहीं हो सकती। ,21,31,-10
7931,It was later seized by the police. ,बाद में किसी तरह पुलिस वालों ने इसे पकड़ा. ,35,43,-8
7936,An FIR should be in the words of the complainant. ,एफआईआर शिकायतकर्ता के शब्दों में होनी चाहिए। ,50,45,5
7944,All photos: abhishek shukla ,सभी फोटोः तहलका अार्काइव ,28,25,3
7946,no version set (programmer error) ,कोई संस्करण नियत नहीं (प्रोग्रामर त्रुटि) ,34,42,-8
7956,"In addition,... ","इसके अतिरिक्त, . ",16,17,-1
7957,Let us first look at credit. ,आइये पहले ऋण पर निगाह डालते हैं। ,29,33,-4
7961,"""The Sonepat police has arrested ",सोनीपत पुलिस ने दिल्ली से पकड़ा ,33,32,1
7962,Police seized the body and conducted postmortem. ,पुलिस शव पोस्टमार्टम और मर्ग कायम कर लिया है। ,49,46,3
7963,You can punish him. ,उसे सजा सँवार सके। ,20,19,1
7982,said Kamal Nath ,"कमलनाथ ने कहा, ",16,15,1
7987,Both of them lifted it. ,दोनों ने बांहें चढ़ा लीं। ,24,25,-1
7995,Indian army is fully organised. ,भारतीय सेना पूरी तरह से चौकन्नी हो गई है। ,32,42,-10
7999,companies that earn ,जुटाएंगी कंपनियां ,20,18,2
8023,It is recorded at Leviticus 19: 18. ,यह नियम लैव्यव्यवस्था 19: 18 में दर्ज़ है । ,36,44,-8
8025,This will grow. ,इसे बढ़ाया जाएगा। ,16,17,-1
8030,Spanish sounds ,स्पैनी ध्वनि ,15,13,2
8035,Tomorrow's game will commence at 0300. ,कल के खेल 0300 में शुरू होगा. ,39,30,9
8039,Thanks for your love & support. ,आपके प्यार और मार्गदर्शन के लिए धन्यवाद। ,32,41,-9
8042,What ails English teaching? ,अंग्रेजी पढऩे में हर्ज क्या है? ,28,32,-4
8043,No one was injured in this accident. ,इस हादसा में ज्यादा नुकसान नहीं हुआ. ,37,37,0
8060,How did he die? ,यह कैसे मर गया? ,16,16,0
8061,His condition is stable following a surgery. ,ऑपरेशन के बाद शख्स की हालत स्थिर है। ,45,37,8
8079,I have not assaulted anyone. ,मैंने किसी से मारपीट नहीं की। ,29,30,-1
8092,Fire cannot burn it. ,उससे आग नहीं लग सकती है। ,21,25,-4
8093,"""The Rural Hospital ",ग्रामीण अस्पताल ,20,16,4
8094,He hasn't lost any election so far. ,इन्होंने अभी तक एक भी चुनाव नहीं हारा है। ,36,42,-6
8098,High Resolution ,उच्च रिज़ोल्यूशन ,16,17,-1
8105,"However, India fell 31 runs short in the end. ",हालांकि भारत यह मैच 31 रनों से हार गया. ,46,40,6
8109,I hadnt seen anything like that before. ,मैंने ऐसे पहले बहुत कम देखा है. ,40,32,8
8111,Add to Project ,परियोजना में जोड़ें (A) ,15,24,-9
8118,"Section - 15, Right to Information Act, 2005 ","धारा - 15, सूचना का अधिकार अधिनियम, 2005 ",45,41,4
8121,"""Then some other people do the same. ",उसके बाद दूसरे लोग भी उसके साथ ऐसा ही करेंगे। ,37,46,-9
8125,"""The couple have two sons. ",जोड़ी की दो बेटियां हैं. ,27,25,2
8126,"""The police said investigations were underway. ",पुलिस ने कहा कि बचाव अभियान जारी है। ,47,37,10
8127,"She was a beautiful woman, petite and delicate. ","""वह हृष्टï-पुष्टï, कद्दावर, दबंग किस्म की औरत थी। ",48,50,-2
8135,This time will also go. ,यह समय भी निकलेगा ही। ,24,22,2
8137,wrote one Witness of Jehovah. ,यहोवा के एक साक्षी ने लिखा । ,30,29,1
8138,Senior police officials reached the spot. ,घटनास्थल पर वरिष्ठ अधिकारी पहुंच गए हैं। ,42,41,1
8140,It can occur at any age. ,ऐसा किसी भी उम्र में हो सकता है। ,25,33,-8
8144,An overloaded auto-rickshaw ferries school ,पीछा कर ओवरलोडिड स्कूल वैन पकड़ी ,43,33,10
8148,You will get parental support. ,अभिभावकों का सहयोग मिलेगा. ,31,27,4
8152,He expressed his concerns over the issue. ,उन्होंने इसे लेकर अपनी चिंता जाहिर की। ,42,39,3
8158,A search operation is still underway in the area. ,Tral इलाके में सर्च ऑपरेशन अभी भी जारी है। ,50,43,7
8164,"""The advantages are clear. ",इसके फ़ायदे स्पष्ट हैं. ,27,24,3
8165,He was later discharged after recovery ,इसके बाद उनको जमानत कर रिहा किया गया है। ,39,41,-2
8167,We are hopeful that a solution will be found. ,हमें उम्मीद है कि इसका कोई समाधान निकल आएगा। ,46,45,1
8182,You can make your own scrub at home. ,चाहें तो घर पर खुद भी स्क्रब बना सकती हैं। ,37,43,-6
8185,Amar Singhs effigy burnt ,फूट पड़ा अमर सिंह का गुबार ,25,27,-2
8186,Let's cut down our expenses. ,हमें अपने खर्चे कम करने होंगे। ,29,31,-2
8193,Business school ,बिजनेस स्कूल्स ,16,15,1
8197,"Take, for example, pulses. ","उदाहरण के लिए, दालों को लें। ",27,29,-2
8201,Death is always sad. ,मृत्यु हमेशा पीड़ा देती है। ,21,27,-6
8210,Maybe hes never even considered it. ,शायद इसकी कल्पना भी उन्होंने न की होगी। ,36,40,-4
8213,Expanded Activity ,बढ़ता काम ,18,10,8
8256,"Now, it is the time to work for economic freedom. ",अब आर्थिक आज़ादी के लिये कार्य करने का समय है। ,50,47,3
8264,translator - credits ,अनुवाद श्रेय ,21,13,8
8265,Your Adrien. ,तुम्हारा Adrien. ,13,17,-4
8267,"However, the sale price is not yet known. ",हालांकि इसकी कीमत का अभी तक खुलासा नहीं हो पाया. ,42,49,-7
8270,All of this is wrong. ,यह सब गलत है. ,22,14,8
8275,BJP govt misleading people: Akhilesh ,जनता को बेवकूफ नहीं बनाये भाजपा : अखिलेश ,37,41,-4
8276,Reporting authority ,रिपोर्ट प्राधिकारी ,20,19,1
8282,We have only seen media reports. ,हमने केवल मीडिया में आई रिपोर्ट देखी है। ,33,41,-8
8288,DivineProportion Shape ,डिवाइनप्रपोर्शन आकारName ,23,25,-2
8289,"""The two,however,are not connected. ",हालांकि ये दोनों रिश्तेदार नहीं हैं. ,36,37,-1
8295,11 runs came from that over. ,इस ओवर से 11 रन आए. ,29,20,9
8315,Farmer castrated ,किसान ने लगाया फंदा ,17,20,-3
8316,Parliaments job is to legislate. ,विधानसभा का कार्य संसद करती है। ,33,32,1
8319,"""The agitated people set the truck on fire. ",आक्रोशित लोगों ने गाड़ी को आग के हवाले कर दिया। ,44,48,-4
8322,This flight is special in many ways. ,ये ट्रेन कई मायनों में खास है. ,37,31,6
8327,He has given us some amazing films. ,उन्होंने हमें कुछ शानदार फिल्में दी हैं। ,36,41,-5
8330,Determined to Bear Thorough Witness ,अच्छी तरह गवाही देने की ठान लीजिए ,36,34,2
8333,No decision has been taken by the board yet. ,अभी बोर्ड या टीम ने कोई फैसला नहीं लिया है। ,45,44,1
8338,So is Facebook. ,वो भी फेसबुक के जरिये। ,16,23,-7
8342,Also There ,"""वहां भी . ",11,11,0
8347,How is this fair? ,यह कैसी नाइंसाफी ? ,18,19,-1
8352,"""The family has not given any statement so far. ",अभी परिवारीजनों ने कोई तहरीर नहीं दी है. ,48,41,7
8367,What accounts for this? ,इसकी वजह क्या है? ,24,18,6
8374,Sheldon Cottrell (Base price Rs 1 crore) ,शेल्डन कॉटरेल (बेस प्राइस 1 करोड़ रुपये) ,41,41,0
8378,"In India, cow is worshipped as God. ",भारत में गाय को पूज्जनीय माना जाता है। ,36,39,-3
8380,Dream came true. ,सपना सच हुआ था। ,17,16,1
8383,"""Theres nothing in it. ",इसमें कुछ नहीं है. ,23,19,4
8389,Mother-daughter love ,बेटी- दमाद करते हैं प्यार ,21,26,-5
8390,Optic neuritis with swelling of the optic disk. ,ऑप्टिक डिस्क के सूजन के साथ ऑप्टिक न्युरैटिस. ,48,46,2
8393,All the government offices functioned normally. ,सभी कार्यालयों ने सुचारू रूप से काम किया। ,48,42,6
8398,Tamil Nadu assembly session began today. ,तमिलनाडु विधानसभा का सत्र आज से शुरू हो गया। ,41,45,-4
8414,Reputation in society will increase. ,समाज में मान प्रतिष्‍ठा बढ़ेगी। ,37,31,6
8424,He also translated Portuguese poems into Hindi. ,कविता का हिंदी अनुवाद भी उन्होंने ही किया था। ,48,46,2
8425,You have parked your car. ,आप कार पार्क करते हैं। ,26,23,3
8429,"""The cause of her death is not known yet. ",हालांकि अभी तक उनके निधन की वजह सामने नहीं आई है। ,42,50,-8
8438,This news has shocked everyone in the industry. ,इस खबर ने पूरी इंडस्ट्री को हिलाकर रख दिया था. ,48,47,1
8439,"""""""It's a very difficult group."" ","उन्होंने कहा, ‘‘यह कठिन ग्रुप है. ",33,34,-1
8441,So stay away from it. ,इसलिए इससे दूर ही रहें। ,22,24,-2
8448,Dispute with cops ,पुलिस से हुई बहस ,18,17,1
8456,Take a look here to know more ,ज्यादा जानकारी के लिए देखें यह ,30,31,-1
8463,"""They are tarnishing his image. ",वे अपनी छवि खराब कर लेते हैं। ,32,30,2
8465,I wont declare. ,मैं घोषणा नहीं करूंगा। ,16,23,-7
8466,A case of murder has been registered. ,मामले में इतेफाकन मौत की कार्रवाई की गई है। ,38,44,-6
8469,Bigamy is prohibitted according to the Hindu law. ,हिंदु कानून के अनुसार द्विविवाह पर प्रतिबंध है। ,50,48,2
8476,So 1 minus cosine of x. ,तो 1 शून्य एक्स की कोज्या। ,24,27,-3
8480,"""Then add the mutton. ",फिर इसमें बटर डालें। ,22,21,1
8482,"""They claimed ",उन्होंने दलील ,14,14,0
8487,Let me now turn to international trade. ,अब मैं अंतर्राष्ट्रीय व्यापार की ओर आता हूं। ,40,45,-5
8493,But sharing of seats had not been discussed yet. ,हालांकि सीटों का बंटवारा अभी नहीं हुआ है. ,49,42,7
8496,"""The enquiry continued till night. ",देर रात तक मामले में छानबीन जारी रही। ,35,38,-3
8502,This will give a lot of confidence to runners. ,इससे यात्रियों का उबर के प्रति भरोसा बढ़ेगा। ,47,44,3
8516,"""The Congress scored only eight seats. ",कांग्रेस को मात्र आठ सीटें हासिल हुई थीं। ,39,42,-3
8521,take up ,चूसना ,8,6,2
8528,It has several subspecies. ,इसकी अनेक जातियाँ हैं। ,27,23,4
8529,But Ashwin wasnt relenting. ,लेकिन अश्विनी पीछे नहीं हटे. ,28,29,-1
8553,"Driver absconding with car, money ",चालान के पैसे लेकर भागा ड्राइवर ,34,32,2
8557,"""Their position is as follows - ",उनकी तैनाती की स्थिति इस प्रकार है: ,32,36,-4
8559,"""There are two possibilities here. ",>> यहां पर आपको दो विकल्प​ मिलेगा. ,35,35,0
8561,"She was, however, let off later. ","हालांकि, बाद में उसे छोड़ दिया। ",33,31,2
8565,Death toll rises to 35. ,घायलों की संख्या 35 हो गई है. ,24,30,-6
8567,Is there any truth in these reports? ,क्या इन आंकड़ों में कोई सच्चाई है? ,37,35,2
8568,Remove the jack of hearts. ,लाल पान का बादशाह हटाएँ. ,27,25,2
8569,Doctors were there as well. ,डॉक्टर्स भी मौजूद रहे। ,28,23,5
8574,A nylon rope was tied around his neck. ,उसमें नॉयलोन की रस्सी का झूला बंधा हुआ था। ,39,43,-4
8577,"""The girl did not know the man. ","""""""लड़की को मैं नहीं जानता था."" ",32,32,0
8581,He was taken for 31 runs in 5 overs. ,उन्होंने 31 गेंदोंकीपारीमें 5 चौकेमारे। ,37,40,-3
8584,Everything has to go on. ,सहे जाना है सबकुछ। ,25,19,6
8592,Load Subtitles... ,सब- टाइटल्स लोड करें... (L) ,18,28,-10
8597,"""The people here lived happily. ",यहाँ के लोग खुशहाली से जीवन बिता रहे हैं। ,32,42,-10
8604,He had realised the truth. ,"""वह इस सच्चाई के प्रति जागरूक थे। ",27,34,-7
8605,He was way ahead of his time. ,"""वह अपने समय के हिसाब से प्रगतिशील था। ",30,39,-9
8606,He has also acted in Bollywood movies. ,"""वह बॉलीवुड फिल्म में भी अभिनय कर चुके हैं। ",39,44,-5
8626,He lives in Kolkata. ,"""वह कोलकाता में रहती है. ",21,25,-4
8630,But until how long? ,लेकिन ऐसा कब तक? ,20,17,3
8644,Traffic was also disrupted at several places. ,कई जगह ट्रैफिक को भी डायवर्ट किया गया है। ,46,42,4
8651,"""They had also demanded a motorcycle. ",उससे मोटर साइकल की मांग भी की जाती थी। ,38,39,-1
8662,"""They need someone to talk to. ",किसी को उनसे बात करनी चाहिए। ,31,29,2
8668,(For Imported Goods) ,(निर्यात वस्तुओं के लिए) ,21,25,-4
8672,He recovered his property from the burglers. ,उसने चोरों से अपनी सम्पत्ति बरामद कर ली। ,45,41,4
8680,He had to go without food for days. ,उसने दिनों तक खाना नहीं खाया। ,36,30,6
8682,Militancy was at its peak then. ,उस समय वहाँ मिलिटेंसी चरम पर थी. ,32,33,-1
8685,One died during treatment. ,इलाज के दौरान एक घायल की मौत हो गई। ,27,36,-9
8687,Rescue work is still underway. ,राहत कार्य अभी भी जारी है। ,31,27,4
8692,"""The trailer of the film was launched in Mumbai. ",फिल्म का पोस्टर मुंबई में लॉन्च किया गया। ,49,42,7
8701,He forcibly took her away in a car. ,उसने जबरन उसे कार में बिठाया था। ,36,33,3
8703,"""The doctors declared him brought dead. ",चिकित्सकों ने उसे मृत घोषित कर दिया। ,40,37,3
8711,India have also made one change in their team. ,"""वहीं, भारत ने अपनी टीम में एक बदलाव किया। ",47,43,4
8722,Consume more fluids. ,तरल पदार्थ का सेवन अधिक करें। ,21,30,-9
8726,Did we really attack? ,क्या हमने वाकई हमला किया? ,22,26,-4
8727,"""The rule of law is the foundation of democracy. ",धर्मनिरपेक्षता ही लोकतंत्र की बुनियाद है। ,49,42,7
8730,First they fired in the air. ,पहले हवा में गोली चलाई गई। ,29,27,2
8733,Expansion plans in business will fructify. ,कारोबार के विस्तार की योजनाएं साकार होंगी। ,43,43,0
8748,She had been living in France since 1993. ,1993 से एक डच महिला से विवाहित हैं. ,42,36,6
8751,Start / Stop Count ,गिनती आरंभ करें/रोकें ,19,22,-3
8759,"""The matter does not rest here. ",मसला यहीं शांत नहीं हुआ ,32,24,8
8760,"""They must be remembered. ",उन्हें याद रखा जाए. ,26,20,6
8761,"Could you leave them there, please? ","इन्हें वहाँ रखे दो, प्लीज़। ",36,28,8
8767,Society needs to change its mindset. ,समाज की मानसिकता बदलने की जरूरत है। ,37,36,1
8776,And what role do they play? ,और वे कौन - सी भूमिका अदा करते हैं? ,28,36,-8
8782,But it could always change. ,लेकिन इरादे कभी भी बदल सकते हैं. ,28,33,-5
8784,Mushrooms are rich in nutrients. ,मूंग दाल पोषक तत्वों से भरपूर होती है । ,33,40,-7
8797,Not talking ,बोलती हैं न। ,12,13,-1
8807,What are the roots of oppression? ,छापेमारी की जड़ क्या हैं? ,34,26,8
8812,in North India. ,उत्तर भारत में. ,16,16,0
8815,Wright brothers ,राइट बंधु ,16,10,6
8821,"""There are multiple benefits to this. ",इससे अनेकानेक लाभ होते हैं। ,38,28,10
8832,So what do you prefer? ,सो क्या है पसंद? ,23,17,6
8838,But this does not cover everything. ,लेकिन यह अभी भी हर चीज को कवर नहीं करती है। ,36,44,-8
8839,Weve set up a committee. ,हमने एक कमेटी का गठन कर दिया है. ,25,33,-8
8842,You can choose any of these options. ,इसमें से आप किसी भी विकल्प को चुन सकते हैं। ,37,44,-7
8843,Dev - Unstable ,विकास-अस्थिर ,15,13,2
8845,Do not keep the money. ,पैसों को पकड़ मत। ,23,18,5
8853,"""The results have not been happy. ",इसके परिणाम कभी भी सुखद नहीं रहे। ,34,34,0
8856,"""The Supreme Court has adjudicated on the issue. ",इस मामले में शीर्ष अदालत का फैसला आ चुका है। ,49,45,4
8859,What a fine reward that would be! ,और यह हमारी मेहनत का कितना बढ़िया फल होगा! ,34,43,-9
8862,Rohit also claimed one wicket. ,रोहित ने एक टाई भी खेला है। ,31,28,3
8884,He had left the house early this morning. ,"""वह सुबह टहलने के लिए घर से निकली थी। ",42,38,4
8887,advertisement. or ,विज्ञापन. या ,18,13,5
8888,"St. Francis Church, Kochi ","सेंट फ्रांसिस चर्च, कोचीन ",26,26,0
8898,It will release soon. ,जिसे जल्द ही रिलीज किया जाएगा। ,22,31,-9
8907,"Of those, two have died. ",उनमें से दो की मौत हो गई है. ,25,29,-4
8908,"Yes, you are right. ","‘सकीना, सही कहती हो। ",20,21,-1
8909,In a few days you will see a difference. ,कुछ दिनों में इसका फर्क आपको साफ नजर आएगा। ,41,43,-2
8911,Try it out! ,आजमाई जाए! ,12,11,1
8915,Both came close to each other. ,दोनों एक-दूसरे के करीब आ गए. ,31,29,2
8919,Build Ram in your heart: Tharoor ,राम को अपने दिल में बसाएं: थरूर ,33,32,1
8920,can be utilised. ,एक प्रयोग किया जा सकता है। ,17,27,-10
8923,photolash Ex ,फोटोलाश पूर्व ,13,14,-1
8924,"Though, we never follow each others advice. ","लेकिन, हम एक दूसरे की सलाह नहीं मानते। ",44,39,5
8925,Writing Mode ,लिखने का मोड ,13,13,0
8926,Im helpless. ,मैं बेबस हूं. ,13,14,-1
8929,Expenditure will increase. ,व्यय में बढ़ोतरी होगी। ,27,23,4
8930,That's where children experience life. ,"""वही पर बच्चों को जीवन का अनुभव होगा ",39,37,2
8931,Did it work? ,क्या काम बन गया ? ,13,18,-5
8933,"""The project will cost around Rs 650 crore. ",इस पर लगभग 612 करोड़ रुपये का खर्च आएगा। ,44,41,3
8943,Appeal to Central Government. ,केन्द्रीय सरकार को अपील ,30,24,6
8946,"PAGE 19 SONGS: 98, 104 ","पेज 19 • गीत: 44, 9 ",23,20,3
8954,Move Item & Down ,वस्तु मिटाएँ ,17,13,4
8956,Kit Harington in Game Of Thrones ,"किट हैरिंगटन, गेम ऑफ थ्रोन्स ",33,29,4
8958,and caused much corruption in them: ,और उनमें बहुत बिगाड़ पैदा किया ,36,31,5
8963,non - water intensive crops ,बिना पानीवाली गहन फसलें ,28,24,4
8970,We answer. ,जवाब हम देते हैं. ,11,18,-7
8975,Changing society ,बदलेगा समाज ,17,12,5
8977,TREVOR: Yeah. ,"जाओ, जाओ, जाओ. ",14,15,-1
8978,This is normal too. ,ये भी आम है. ,20,13,7
8980,AR Rahman will be composing the music. ,एआर रहमान संगीत की प्रस्तुति देंगे। ,39,36,3
8984,After that they could not find any jobs. ,जिसके बाद उनका मेहनताना उन्हें नहीं मिला था। ,41,45,-4
9002,So they dont do anything about it. ,इसलिए वे उन पर कोई कार्रवाई नहीं कर सकते। ,35,42,-7
9003,"""""""It is all false"" ",सब झूठ हैं। ,20,12,8
9007,Five accused arrested ,पांचों आरोपी गिरफ्तार ,22,22,0
9011,This allows you to save a lot of time. ,इससे काफी समय बचाया जा सकता है। ,39,32,7
9013,"Earthquake tremors felt in Delhi, nearby areas ",दिल्ली व आसपास के इलाकों में भूकंप के झटके ,47,43,4
9017,He was preparing for competitive exams. ,वो प्रतियोगी परीक्षाओं की तैयारियां भी कर रही थी। ,40,50,-10
9021,Both were looking so adorable . ,दोनों ही बेहद खूबसूरत लग रहे थे. ,32,33,-1
9026,And then everything continues as before. ,र सब मानो पहले जैसा होता जा रहा है। ,41,36,5
9028,"""The trailer of the film is out. ",फिल्म का ट्रेलर आ चुका है। ,33,27,6
9031,It was a pretty tough time. ,यह काफी कठिन समय था. ,28,21,7
9036,What is the rule ,क्या है अध्यादेश ,17,17,0
9038,Its not very expensive either. ,जिनकी कीमत बहुत ज्यादा नहीं होती। ,31,34,-3
9046,Cops are investigating the case. ,सीओ सिटी मामले की जांच कर रहे हैं। ,33,35,-2
9059,Further investigation is on in this case. ,इस मामले में आगे जांच चल रही है। ,42,33,9
9064,What do the investigators say? ,क्या कहते है जांच अधिकारी : ,31,28,3
9065,That is where we live. ,जहां हम रहते हैं। ,23,18,5
9069,Asian Championship ,एशियाई चैम्पियनशिप ,19,19,0
9076,But no one knows who actually did that. ,"लेकिन वास्तव उनके साथ क्या हुआ, किसी का नहीं पता. ",40,50,-10
9077,"Dera Bassi, November 1 ","चरखी दादरी, 1 नवंबर (निस) ",23,26,-3
9078,Nudges banks to cut lending rates ,बैंकों ने ब्याज दरों में कटौती की ,34,34,0
9083,Her fathers name was Rajaram Yadav. ,उनके पिता का नाम यादप्पा था। ,36,29,7
9084,Its going to be very important for us. ,यह हमारे लिए काफी महत्त्वपूर्ण होने जा रहा है। ,39,47,-8
9085,I had entered college by then. ,उससे पहले मैं कॉलेज में थी। ,31,28,3
9087,Its disgraceful. ,यह घ‌िनौना है. ,17,15,2
9091,So it's going to come in like that. ,तो यह उस तरह में आने के लिए जा रहा है। ,36,39,-3
9093,I don't understand all that. ,मैं इस पूरे मामले से अनजान हूं। ,29,32,-3
9099,Oil to cook ,खाना बनाने के लिए तेल ,12,22,-10
9105,Go from here. ,चल फुट यहां से। ,14,16,-2
9106,This is not Indian culture. ,ऐसी तो नहीं है भारतीय संस्कृति ,28,31,-3
9111,But is doesn't stop there. ,हालांकि यह मामला यहीं खत्म नहीं हुआ। ,27,37,-10
9118,20 people have died in the incident. ,जिसके कारण 20 लोगों की मौत हो गई। ,37,34,3
9121,"""He left our country,"""" he added."" ",उसने हमारा देश छोड़ दिया। ,35,26,9
9125,It affected the daily life of the people. ,इससे सामान्य जनजीवन प्रभावित हुआ है। ,42,37,5
9126,This makes it malicious. ,ऐसा करने से अमंगल होता है। ,25,27,-2
9127,He was in the Congress then. ,कभी कांग्रेस में रहे थे. ,29,25,4
9128,covid panic ,कोविड घबड़ाहट ,12,14,-2
9130,I said alright. ,मैने कहा ठीक है। ,16,17,-1
9134,This is called 'drug interactions'. ,इल्ही को ‘औषधि परस्पर क्रिया’ कहते हैं। ,36,40,-4
9138,"At this occasion, school Principal Dr ",इस मौके पर कालेज की प्रिंसिपल डा. ,38,34,4
9146,"What, and our forefathers, the ancients' ","""क्या और हमारे पहले के बाप-दादा भी? """""" ",41,40,1
9151,That too is far from truth. ,यह भी सच्चाई से इतर है। ,28,24,4
9152,That's it. ,बिलकुल ऐसे ही। ,11,15,-4
9158,"""There are two main groups in the fray. ",इस संगठन में दो प्रमुख गुट हैं. ,40,32,8
9160,People are in shock. ,लोगों को शॉक लगा है। ,21,21,0
9167,"""The family asked permission to pray first. ",परिवार ने पहले प्रार्थना करने की अनुमति माँगी । ,44,48,-4
9173,"Time's up, Bogs? ","समय समाप्त हुआ, बॉग्स. ",17,23,-6
9174,And also not. ,और केउ नाहीं. ,14,14,0
9177,"""They should be ostracised. ",उनका बहिष्कार किया जाना चाहिए। ,28,31,-3
9183,Extension root directory is invalid. ,विस्तार मूल निर्देशिका अमान्य है. ,37,34,3
9192,Some are mill workers and some are farmers. ,कोई खेतिहर मजदूर है तो कोई किसान. ,44,34,10
9201,Police have asked the public to exercise caution. ,"इस बीच, पुलिस ने लोगों से सचेत रहने को कहा है। ",50,47,3
9202,%1 has left the game ,% 1 ने खेल छोड़ दिया ,21,21,0
9207,I still wasn't aware of what was happening. ,"जो कुछ हो रहा था, मैं उससे अनजान था. ",44,37,7
9208,"After this, he released many music videos. ",इसके बाद उन्होंने कई म्यूजिक वीडियोज किए हैं। ,43,46,-3
9210,Bulk Feeder ,बल्क फीडर्स ,12,12,0
9221,"who acknowledge the Day of Judgment, ","जो बदले के दिन को सत्य मानते है, ",37,33,4
9224,How to care for your children ,आप अपने बच्चों को किस तरह से रखते हैं? ,30,39,-9
9232,Although th...Read More ,हालांकि इसकी . पढ़ें ,24,21,3
9243,Desai was ecstatic. ,देसाई हतप्रभ रह गये. ,20,21,-1
9244,He is interested in hearing her story. ,"""वह कहानी सुनाने को तैयार हो गई। ",39,33,6
9254,What more do you want? ,और क्या चाहिए तुझे। ,23,20,3
9255,He lived alone in the village. ,"""वह गांव में ही खेतीबाड़ी करता था। ",31,35,-4
9257,Anyone found guilty will not be spared. ,अपराधी कोई भी हो उसे बख्‍शा नहीं जाएगा। ,40,40,0
9261,Tell me your address. ,आपका पता बताइए। ,22,16,6
9264,Set here the raindrops' size. ,यहाँ पर पानी की बूंदों का आकार सेट करें ,30,40,-10
9265,So we decided to do that. ,इसलिए हमने ऐसा करने का फैसला किया। ,26,35,-9
9267,Strict vigil in border areas ,सीमावर्ती इलाकों में चौकसी ,29,27,2
9272,"Speak up, son. ","स्पीक अप, बेटा. ",15,16,-1
9276,We aren't fussy at all ,हमको ही ख़ासकर नहीं मिलती ,23,26,-3
9284,"""They are both very good friends. ",उन दोनों की अच्छी दोस्ती है। ,34,29,5
9289,To the lake! ,शांत रहो! घायल मदद! ,13,20,-7
9290,"""The event has caused anger in the US. ",अमेरिका में इस घटना ने सनसनी मचाकर रख दी है। ,39,45,-6
9291,A Bible study was started with the entire family. ,पूरे परिवार के साथ बाइबल अध्ययन शुरू किया गया । ,50,48,2
9305,We must hide! ,हम छिपाना चाहिए! ,14,17,-3
9310,9 deaths were reported. ,जिसमें 9 लोगों की मौत हो चुकी है। ,24,34,-10
9311,"you attended to him, ",तू उसके पीछे पड़ा है- ,21,22,-1
9318,"""The accused boy has been apprehended. ",नाबालिग आरोपी को हिरासत में लिया हुआ है। ,39,41,-2
9321,See the tweets below: ,नीचें देखे ट्वीट्स : ,22,21,1
9322,"""The three were stabbed to death. ",पिटाई से तीनों अधमरे हो गए। ,34,28,6
9325,This number will be increased in the coming days. ,पर आने वाले दिनों में यह संख्या बढ़ सकती है। ,50,45,5
9335,"""They immediately called on 100 number. ",उसने तुरंत 100 नंबर पर फोन किया। ,40,33,7
9336,Why there is no compensation? ,कोई शिक़ायत क्यों नहीं होती? ,30,29,1
9339,Thats why this step has been taken. ,इसी के चलते उसने ऐसा कदम उठाया है। ,36,35,1
9345,ChinaLove: dating app for Chinese singles ,चाइनालव: डेटिंग ऐप फॉर चाईनीज सिंगल्स ,42,38,4
9347,Annual Statistics various years ,विभिन्‍न वर्षों के लिए सालाना आंकड़े ,32,37,-5
9356,Suit yourself. ,अपने आप को सूट. ,15,16,-1
9357,But it is fast. ,पर जल्दी है तो है। ,16,19,-3
9368,We are discussing that. ,हम इस पर बातचीत करते हैं। ,24,26,-2
9371,I already have ten children myself ,मेरे खुद के दस बच्चे हैं ,35,25,10
9376,Its already too late. ,पहले ही देर हो गई है। ,22,22,0
9377,Maybe I ought to be a little braver. ,मुझे शायद थोड़ा बहादुर बनना चाहिए। ,37,35,2
9379,List of new words ,नए शब्दों की सूची ,18,18,0
9386,"""The cheese is very low in fat. ",मादा पशु दूध बहुत कम मात्रा में देती है। ,32,41,-9
9390,neighbourhood travel scheme ,पड़ोसी देशों की यात्रा योजना ,28,29,-1
9403,You will need additional help. ,आपको अतिरिक्‍त मदद की भी ज़रूरत होगी । ,31,39,-8
9419,"""There can be three explanations for this: ",इसे निम्न तीन बिंदुओं से समझा जा सकता है ,43,41,2
9421,Indian banyan ,नीलरूपक ,14,8,6
9432,All this variation is not surprising ,ये सारी भिन्नताएं हतप्रभ करने वाली नहीं हैं। ,37,45,-8
9433,BSNl cables stolen ,बीएसएनएल की केबल चुराई ,19,23,-4
9434,"""The situation in the state is altering rapidly. ",राज्‍य में स्थिति तेजी से सामान्‍य हो रही है। ,49,46,3
9436,We have asked them. ,हमने उनसे पूछा है। ,20,19,1
9442,"""The video went viral. ",ये वीडियो तेजी से वायरल हुआ. ,23,29,-6
9444,Hockey WC: Shivendra Singh suspended ,हॉकी विश्व कप: शिवेंद्र की सजा घटी ,37,35,2
9458,All three of them. ,इन तीनों से ही. ,19,16,3
9462,Page% 1 of% 2 ,पृष्ठ% 1 इसमें काः% 2 ,14,22,-8
9466,"""The film also stars Manisha Koirala. ",इसमें मनीषा कोइराला भी प्रमुख भूमिका में हैं। ,38,46,-8
9467,Vermaji was not far from truth. ,वर्मा जी ने ठीक ही कहा था। ,32,27,5
9468,"""The government has rejected that demand. ",सरकार ने इस मांग को भी ठुकरा दिया. ,42,35,7
9469,It is violation of international laws. ,यह अंतरराष्ट्रीय समझौतों का उल्लंघन भी है। ,39,43,-4
9473,She has severe injuries on her body. ,उसके शरीर पर गंभीर चोट के निशान हैं। ,37,37,0
9475,Always apply changes without confirmation ,परिवर्तनों को हमेशा बिना पुष्टि किए लागू करें ,42,46,-4
9490,But where does this money come from? ,"वैसे भी, यह रकम कहां से आएगी? ",37,30,7
9492,"You 're a clever boy, Pelle. ","तुम एक चतुर लड़के हो, पेले. ",29,28,1
9495,"""The court however did not accept their plea. ",अदालत ने अभी उनका दावा स्वीकार नहीं किया है। ,46,45,1
9499,This has led to a new controversy. ,इस मामले में नया विवाद खड़ा हो गया है. ,35,39,-4
9501,We are currently in the evaluation process. ,हम अभी सिर्फ आकलन की प्रक्रिया में हैं। ,44,40,4
9503,"At first,I rejected it completely. ",शुरू में मैंने मना कर दिया. ,35,28,7
9515,It was raining in several places. ,इसके चलते कई स्थानों पर बारिश हुई। ,34,35,-1
9519,Baig was not immediately available for comment ,बेग तत्काल टिप्पणी के लिए उपलब्ध नहीं थे ,47,41,6
9521,Heavy rain in Haryana ,हरियाणा में गिरे ओले ,22,21,1
9529,"""The dock's history ",खंडाला का इतिहास ,20,17,3
9532,"Lots of patches, fixes, updates ","बहुत से पैचेस, फ़िक्सेस, अपडेट्स ",32,33,-1
9535,He is happy with the film's success. ,"""वह इस फिल्म के प्रदर्शन से खुश हैं. ",37,37,0
9540,This release issued at 1415 hrs. ,यह विज्ञप्ति 1415 बजे जारी की गई।. ,33,35,-2
9541,Ben Stokes was awarded the Man of the Match. ,बेन स्‍टोक्‍स को मैन ऑफ द मैच घोषित किया गया। ,45,46,-1
9543,Shruti files a missing person report for Jhilmil. ,श्रुति झिलमिल के लापता होने की रपट लिखवा देती है। ,50,50,0
9553,"""The fort was named Bala Kila by Cunningham ",इस किले का नाम कन्निंघुम के द्वारा रखा गया। ,44,44,0
9571,"Man, 7-year-old daughter murdered ",बाप ने तीन साल के बेटे को मार डाला ,34,35,-1
9578,You dont have any problems. ,किसी भी तरह की समस्या आपको न होगी। ,28,35,-7
9579,It is the biggest scam. ,यह सबसे बड़ा स्कैम है। ,24,23,1
9583,Lucky Number: 1. Lucky Colour: Red ,तुला शुभ अंक: 1 शुभ रंग: बैंगनी ,35,32,3
9586,Samsung Galaxy M51: Expected specifications ,Samsung Galaxy M12 की संभावित स्पेसिफिकेशन ,44,43,1
9587,Related or associated fibres. ,संबंधित या जुड़े हुए रेश। ,30,26,4
9595,6 members of thieves gang arrested ,काला मान गिरोह के 6 सदस्य काबू ,35,31,4
9602,Farmers seek support price ,किसानों ने मांगा समर्थन मूल्य ,27,30,-3
9607,Deaths continue ,अभी भी मौतें जारी ,16,18,-2
9609,But it has indeed happened. ,परंतु ऐसा सचमुच हुआ है। ,28,24,4
9610,"New York, July 28 ","रतिया, 28 जुलाई (निस) ",18,22,-4
9621,"""There can be exceptions. ",इसमें कुछ अपवाद अवश्य हो सकते हैं। ,26,35,-9
9624,What do the experts say? ,क्या कहते हैं विशेषज्ञ ,25,23,2
9632,"""The relationship ended in February 2009. ",यह रिश्ता फरवरी 2009 में समाप्त हो गया। ,42,40,2
9634,"And the heaven and Him Who made it, ","और आकाश और जैसा कुछ उसे उठाया, ",36,31,5
9635,Clash between police and protestor ,पुलिस और प्रदर्शनकारियों के बीच धक्का-मुक्की ,35,45,-10
9639,What has become of us? ,हम लोग क्या बन गए हैं? ,23,23,0
9642,What the newspapers report? ,अख़बार में क्या छप रहा है? ,28,27,1
9643,STANDARD DEDUCTION ,स्टैंडर्ड डिडक्शन ,19,18,1
9648,Thats where the world is heading. ,दुनिया हिसाब से चलती कहां है। ,34,30,4
9665,"""There are several more such examples. ",इस तरह के कुछ और उदाहरण हैं. ,39,29,10
9667,This classification was generally accepted. ,उनके इस सिध्दांत को साधारणतया अपना लिया गया। ,44,45,-1
9669,But slowly. ,लेकिन धीरे से। ,12,15,-3
9673,"""The accused left her and escaped. ",आरोपित उसे छोड़ कर पैदल ही फरार हो गया. ,35,40,-5
9691,He immediately informed police. ,उन्होंने पुलिस को तुरंत बताया। ,32,31,1
9694,One is Pune and the other is Bengaluru. ,कुछ पुणे में और एक बेंगलूर में। ,40,32,8
9704,We are concentrating on sanitation and health. ,हम साफ-सफाई का विशेष रूप से ध्यान रख रहे हैं। ,47,46,1
9708,It will never end. ,यह कभी खत्म नहीं हो। ,19,21,-2
9710,But you will soon come to know. ,देखो तुमको अनक़रीब ही मालुम हो जाएगा ,32,36,-4
9716,We dont even feel strange about it. ,हमें कोई अजीब नहीं लगता है. ,36,28,8
9719,Hailstorm in several areas ,कई इलाकों में कम हुई बारिश ,27,27,0
9726,Here theres no such thing. ,यहां ऐसा कोई मामला नहीं है ,27,27,0
9741,One is external and one is internal. ,एक इनडोर और दूसरा आउट डोर. ,37,27,10
9742,But we arent thinking about them. ,लेकिन हमारा ध्यान इन बातों पर नहीं है। ,34,39,-5
9743,seized weapons ,जब्त किए जाएंगे हथियार ,15,23,-8
9759,But the police arent ready to even read it. ,", लेकिन पुलिस मानने को तैयार नहीं। ",44,35,9
9760,How does he do that? ,यह मैं कैसे कर पाऊंगा? ,21,23,-2
9761,"""The reasons for the accident are still unknown. ",दुर्घटना के कारणों को पता अभी नहीं चला है। ,49,43,6
9764,Children are named after him. ,बच्चे उनका नाम रख देते हैं. ,30,28,2
9765,So all is well! ,तो भइया सब बढ़िया है! ,16,22,-6
9769,"So, when you are free, strive hard, ",तो जब तुम फारिग़ हो जाओ तो मुक़र्रर कर दो ,36,42,-6
9770,Later they returned to Balkh. ,बाद में वे बाल्क लौट आए। ,30,25,5
9772,"With aging, its formation gets reduced. ",उम्र बढ़ने पर इनके बनने में कमी होने लगती है। ,40,46,-6
9784,We are ready to deal with any situation. ,कहा- हम किसी भी स्थिति से निपटने को हैं तैयार ,41,46,-5
9785,"""They will get better price for the produce. ",इससे उन्हें अपनी उपज के लिए अच्छी कीमत मिल सकेगी। ,45,50,-5
9802,have been approved. ,स्वीकृत कर दिए हैं। ,20,20,0
9805,Three AK-47 rifles were taken from them. ,इन हथियारों में तीन एके-47 रायफलें भी शामिल हैं। ,41,49,-8
9814,Police pounced on him and arrested him. ,पुलिस ने मुस्तैदी दिखाते हुए उसे काबू कर लिया। ,40,47,-7
9815,Reporter: Why? ,इंटरव्यूअर: क्यों? ,15,19,-4
9817,"""Thereafter, I was thrashed. ",इसके बाद मुझसे गैंगरेप किया गया। ,29,33,-4
9822,Cisco - 6701 ,सिस्को - ६७०१ ,13,14,-1
9824,He had shelled out Rs 1 lakh for this. ,इसके लिए उसने 1 करोड़ रुपए तक खर्च कर दिए थे। ,39,46,-7
9827,He faced many challenges during these trips. ,उनको इस अभियान के दौरान कई मुश्किलें सामने आईं. ,45,48,-3
9828,But this wasnt all. ,मगर ये भीड़ यूं ही नहीं थी। ,20,28,-8
9833,Confirm passphrase ,पासफ़्रेज़ की पुष्टि करें ,19,26,-7
9837,"""The declaration said. ",घोषणापत्र में कहा गया ,23,22,1
9843,Her family was very poor. ,उनका परिवार काफी गरीब है. ,26,26,0
9845,Trump's statement ,ट्रंप का बयान ,18,14,4
9846,Discussions have been on since. ,इसके बाद से चर्चाओं का दौर जारी है. ,32,36,-4
9854,"""There were discussions on that. ",इस पर उनमें बहस हो गई। ,33,23,10
9858,Turtle code files ,टर्टल कोड फ़ाइलें ,18,18,0
9859,"""The Army has recovered four bodies. ",सेना ने चारों के शव बरामद कर लिए हैं। ,37,38,-1
9864,"""The ground has to be prepared. ",उसके लिए जमीन तैयार करनी होगी। ,32,31,1
9868,"""These are difficult times for you. ",यह आपके लिए मुश्किल समय है. ,36,28,8
9898,Here are the latest updates on Delhi-NCR traffic. ,देखिए दिल्ली-एनसीआर से जुड़ी लेटेस्ट खबरें. ,50,44,6
9900,I me... ,मेरे और . ,8,10,-2
9915,Many accolades and awards ,मिले कई पुरस्कार और सम्मान ,26,27,-1
9917,But he would not stay there long. ,पर वे अस्पताल में ज्यादा देर रहे ही नहीं। ,34,42,-8
9918,"Dhudike (Moga), November 6 ","गुहला-चीका, 7 नवम्बर (निस)। ",27,28,-1
9919,Congress couldn't even open its account. ,कांग्रेस खाता भी नहीं खोल सकी है। ,41,34,7
9921,All of us were present there then. ,तो हम वहां इस सबके बीच थे। ,35,27,8
9928,"""The government is considering its proposal. ",सरकार इस प्रस्ताव पर विचार कर रही है. ,45,38,7
9931,Lab confirmed cases reported during the Week ,सप्ताह में प्रयोगशाला द्वारा पुष्ट मामले ,45,41,4
9933,I will personally take you to a psychiatrist. ,मैं खुद तुम्हें मनोचिकित्सक के पास लेकर जाऊंगा. ,46,48,-2
9946,Flight attendant ,उड़ान परिचर ,17,12,5
9950,I am not weak. ,मैं कमजोर नहीं हूं। ,15,20,-5
9954,Calming the Storm ,तूफान को शांत करना ,18,19,-1
9956,All the teams have qualified for Olympics. ,सभी टीमें ओलंपिक के लिये क्वालीफाई कर चुकी हैं। ,43,48,-5
9957,Large White Pointer ,बड़ा सफेद संकेतक ,20,17,3
9963,"""The students said it ",छात्रा ने बताई ये बातें ,22,24,-2
9968,23 Do You Share Jehovahs Sense of Justice? ,23 क्या आप यहोवा के न्याय के स्तरों पर चलेंगे? ,43,47,-4
9970,Wicked Practices Abound ,दुष्ट काम बढ़ते जाते हैं ,24,25,-1
9975,What is it? ,~ तुरंत क्या है? ,12,17,-5
9976,She is not informed of it. ,उसे इसकी कोई खबर नहीं। ,27,23,4
9977,I want things to keep evolving. ,मैं चाहता हूं कि बात आगे बढ़े. ,32,31,1
9979,Video/photography ,फोटो और वीडियो स्त्रोत ,18,23,-5
9991,"""The cases against him are not ordinary ",फ़िलहाल आने वाले मामले आम नहीं हैं ,40,35,5
